addressableCommitteesCommittee: addressableCommitteesCommitte
drasticallyCorrespondence: drasticallyCorrespondance
latestPreparedMoving: latestPreparedMoveing
liaisonLevel: liaisonLevaal
descriptionConsiderEdition: descriptionConsiderEdiion descriptionConsiderEdiition
parallelForecast: parallelForcast
benefitsPossible: benefitsPossable
annoyingVisitorsImmediately: annoyingVisitorsImidatly annoyingVisitorsImediatly
clericalLocallyPersonnel: clericalLocallyPersonnell
totallyJournalism: totallyJournaism
forecastAcquaintancesTechnique: forecastAcquaintancesTecnique
unnecessaryCareer: unnecessaryCarrer
conferenceBenefitsTraditionally: conferenceBenefitsTraditionaly
extremelyCurtainsAbility: extremelyCurtainsAblity
proceedingImmediately: proceedingImidatly proceedingImediatly
voluntaryUmbrella: voluntaryUmberalla
creditParticularExamination: creditParticularEximination
cemeteryUseful: cemeteryUsful
investigatedReceive: investigatedRecieve
uniqueTiming: uniqueTimeing
developChapterAwful: developChapterAwfall developChapterAfful
descriptionMinutesGeographically: descriptionMinutesGoegraphicaly
appealCurrentlyEncompassing: appealCurrentlyEncompasing
possibleNecessity: possibleNessesity
drasticallyConversely: drasticallyConversly
developAppliedReceipt: developAppliedReceit developAppliedReceite developAppliedReciet developAppliedRecipt
throughoutAtmosphere: throughoutAtmospher
standardizingApologisedSeen: standardizingApologisedSeeen
splendidAccountNight: splendidAccountNite
accessibilityBuildFurther: accessibilityBuildFuther
poetryAdequate: poetryAdiquate
appreciatedCorporateLieu: appreciatedCorporateLiew
separateApproachedAtmosphere: separateApproachedAtmospher
movingOrdinaryCareers: movingOrdinaryCurrers movingOrdinaryCarrers
accordingCemetery: accordingCemetary accordingSemetary
separationUnion: separationUnioun
falseGalleryControlled: falseGalleryControled
varietyResponsibilitiesCemetery: varietyResponsibilitiesCemetary varietyResponsibilitiesSemetary
briefEspeciallySupplementary: briefEspeciallySuplementary
juiceErroneous: juiceErrounous
operatorLiaison: operatorLiaision operatorLiason
careerAbilityManually: careerAbilityManualy
initialPoems: initialPoims initialPomes
sheetsWidely: sheetsWidly
pleasantOutputTotally: pleasantOutputTotaly
adequatelyEstablishing: adequatelyAstablishing adequatelyEstablising
buildDiagrammaticallySuccessful: buildDiagrammaticallySucssuful buildDiagrammaticallySuccesful
availabilityWroteDescribed: availabilityWroteDiscribed availabilityWroteDescribd
techniqueDeclarationsScissors: techniqueDeclarationsScisors techniqueDeclarationsSissors
aggravatingWeaponsOpposite: aggravatingWeaponsOpisite aggravatingWeaponsOppasite aggravatingWeaponsOppesite aggravatingWeaponsOppisit aggravatingWeaponsOppisite aggravatingWeaponsOpposit aggravatingWeaponsOppossite aggravatingWeaponsOppossitte
accommodationCurrently: accommodationCurruntly
primarilyParticularlyTechniques: primarilyParticularlyTecniques
speakingSplendid: speakingSpledid speakingSplended speakingSplened
benefitSuccessfulArranging: benefitSuccessfulAranging
occurredFunctionally: occurredFunctionaly
outputInconvenient: outputInconvienient outputInconvient outputInconvinient
sessionMeans: sessionMeens
availableGenevaCertain: availableGenevaCirtain
profitsReceiveNecessary: profitsReceiveNeccesary profitsReceiveNecesary profitsReceiveNecassary profitsReceiveNecassery profitsReceiveNeccasary
hierarchicalFamiliesRemind: hierarchicalFamiliesRemine hierarchicalFamiliesRemined
falseReceiptConsist: falseReceiptConsisit
discretionAcquaintances: discretionAquantences
associatedSheets: associatedSheertes
speakingSuggested: speakingSugested
completelyAnnual: completelyAnual
possibleExactly: possibleExsactly
currentlyStoppedEmployees: currentlyStoppedEmploies
descriptionDefinitionAvailable: descriptionDefinitionAvaible
majorityUnresolvedDrastically: majorityUnresolvedDrasticaly
exceptPivoting: exceptPivting
expansionCriticismInquiries: expansionCriticismEquiries
referredNight: referredNite
applicableOppositeChallenges: applicableOppositeChalenges
problemProfits: problemProffits
whereasGraphicallyAgain: whereasGraphicallyAgiin
difficultyTransferredSplendid: difficultyTransferredSpledid difficultyTransferredSplended difficultyTransferredSplened
referenceCompletelyChapter: referenceCompletelyChaper referenceCompletelyChaphter referenceCompletelyChaptur
experiencesSession: experiencesSesion
togetherChallenges: togetherChalenges
commitLiterature: commitLitriture
projectsBeforePolitics: projectsBeforePolatics
collateSurveyingPatterns: collateSurveyingPattarns
organizationScarcely: organizationScarcly organizationScarecly organizationScarely organizationScarsely
unavailableFavourable: unavailableFaverable
whereasGalleryMeant: whereasGalleryMent
anomaliesEasily: anomaliesEasyly
personnelVoluntary: personnelVolantary
poetryBiscuits: poetryBiscits poetryBiscutes poetryBiscuts poetryBisquits poetryBuiscits poetryBuiscuts
overallJournalismThere: overallJournalismTher
laughEcstasy: laughExstacy laughEcstacy
annoyingBase: annoyingBasse
februaryOperationsDisappointing: februaryOperationsDissapoiting
numbersWillIndependent: numbersWillIndependant
availableApplicable: availableAplicable
developFalse: developFaulse
unionBuilt: unionBiult
appealEnormously: appealEnomosly
profitsAnd: profitsAndd
understandThoughts: understandThorts
furtherArgumentFinancially: furtherArgumentFinancialy
embellishingTogetherReceives: embellishingTogetherRecives embellishingTogetherRecieves
varietyAccording: varietyAcording
allowTraditionally: allowTraditionaly
compareBetween: compareBeeteen
readjustedQuestionnaire: readjustedQuestionare
agenciesUniversity: agenciesUnversity
unexpectedEcstasyCake: unexpectedEcstasyCakee
recommendingBetween: recommendingBeetween
managementResulting: managementReulting
corporateBasically: corporateBasicaly
safeguardAwfulManagement: safeguardAwfulManagment
adequateAnalyseRegained: adequateAnalyseRegined
stomachOccurrence: stomachOccurence
believeOrientated: believeOrentated
apologiesCollateCurrently: apologiesCollateCurruntly
argumentContainingEssential: argumentContainingEsential
surroundingOperationsTiming: surroundingOperationsTimeing
levelAdvantageous: levelAdvantageos
beginningIrrelevantBetween: beginningIrrelevantBeeteen
sufficientPleasant: sufficientPlesent
nightAbilityConceived: nightAbilityConcieved
repetitiveAvailability: repetitiveAvaiblity
abilityTogetherAnd: abilityTogetherAndd
suggestionAggravating: suggestionAgravating
remindDescriptionRecommending: remindDescriptionRecomending
certainAccommodation: certainAccomodation certainAcommodation certainAcomodation
accessAreThey: accessAreThay
universityGuidelines: universityGuidlines
drivenQueriesExponentially: drivenQueriesExponentualy
parallelQuestionnaire: parallelQuestionaire
functionallyAwfulContinued: functionallyAwfulContuned
widelyUnnecessary: widelyUnessessay
whereasJournalismStopped: whereasJournalismStoped
traditionallyContinued: traditionallyContuned
reallyBeginning: reallyBegining
cemeteryCollate: cemeteryColate
laughProfit: laughProffit
studyingSupplementarySeparation: studyingSupplementarySeperation
outputExaminationAdequately: outputExaminationAdequattly
apologiesAnnouncement: apologiesAnouncement
securityDescription: securityDesription securityDescvription securityDesacription
manuallyNegligible: manuallyNegligable
setCareerEspecially: setCareerEspecaily
wantedParallel: wantedParalel wantedParalell wantedParrallel wantedParralell wantedParrallell
necessitatesTransferred: necessitatesTransfred
proceedingCompletely: proceedingCompletly
usefulAppeal: usefulApeal
proportionsInvestigatedSummaries: proportionsInvestigatedSumarys
adequateExpenseGovernment: adequateExpenseGoverment
apparentUnfortunately: apparentUnfortunatly
laterOpportunitySearch: laterOpportunitySerch
widelyGainingCareer: widelyGainingCarrer
supposedlyPerhaps: supposedlyPerhapse
voluntaryWroteInput: voluntaryWroteInut
immediatelyVarious: immediatelyVairious
unequalledAppreciationSession: unequalledAppreciationSesion
continuallyEnormouslyBeneficial: continuallyEnormouslyBenificial continuallyEnormouslyBenficial
necessaryPurple: necessaryPerple necessaryPerpul necessaryPoarple
surveysQueries: surveysQuies
unavailableEarliest: unavailableEarlyest
drivenEstablishingCombine: drivenEstablishingComibine
southernSeparateProcedure: southernSeparateProceduer
careerCommittee: careerComittee
conceivedNecessary: conceivedNecasery conceivedNessasary conceivedNessisary conceivedNeccassary
considerFamilies: considerFamiles
seenDefinitionCollate: seenDefinitionColate
yearsEmbarrassCancellation: yearsEmbarrassCancelation
beforePossibilities: beforePossablities
weightedForbiddenContaining: weightedForbiddenContaing
annoyingGraphicallyGeneva: annoyingGraphicallyGeniva
interpretationDecisions: interpretationDeciscions interpretationDescisions
particularIdeallyAuxiliary: particularIdeallyAuxillary
announcingSuccessfulConsisting: announcingSuccessfulConsisiting
dependenceCakeAnomalies: dependenceCakeAnomolies
progressesReceivingDissension: progressesReceivingDesention
necessityCake: necessityCakee
althoughSeparate: althoughSeporate
utilizedSecurity: utilizedSeurity
employmentFinanciallyArranged: employmentFinanciallyAranged employmentFinanciallyArrainged
challengeOverallSubtract: challengeOverallSubtrcat
pivotingConsider: pivotingConcider
againPersonnel: againPersonel
decideAwfulSurveys: decideAwfulServays
accessValuable: accessValubale accessValuble
hierarchyExperience: hierarchyExperance hierarchyExperiance
correspondenceProgressionWithin: correspondenceProgressionWitin
baseParallelBiscuits: baseParallelBiscits baseParallelBiscutes baseParallelBiscuts baseParallelBisquits baseParallelBuiscits baseParallelBuiscuts
variableDisciplineTransactions: variableDisciplineTrasactions
chapterNationallyClerk: chapterNationallyCleark chapterNationallyClerck
particularEconometricArrangement: particularEconometricArragment
failsAdequateInefficient: failsAdequateIneffiect
eventuallySeparated: eventuallySeperated
transactionsAuntSuggested: transactionsAuntSugested
associatedMonthsAccepted: associatedMonthsAcepted
meansVisitor: meansVistor
surroundingsStudents: surroundingsStudens
majorityInput: majorityInut
monitoringFinancially: monitoringFinancialy
availabilityPolitics: availabilityPolatics
necessitatesPoetryOccurred: necessitatesPoetryOccureed
techniquesReally: techniquesRealy techniquesRelley
announcementConfirmationTheir: announcementConfirmationTher
someoneWantedStudying: someoneWantedStuding
scissorsPoliticsJuice: scissorsPoliticsGuic scissorsPoliticsJuce scissorsPoliticsJucie scissorsPoliticsJuise scissorsPoliticsJuce
benefitsAccompanyingSupersede: benefitsAccompanyingSupercede benefitsAccompanyingSuperceed
parallelTotally: parallelTotaly
anomaliesSource: anomaliesSorce
earliestDiagrammatically: earliestDiagrammaticaally
securityPersonnelNow: securityPersonnelNaaw
functionallyEventually: functionallyEventully
commentsApproach: commentsAproach
resolvedRepresentativeExperience: resolvedRepresentativeExperance resolvedRepresentativeExperiance
embellishingParticularly: embellishingParticulary
discretionAgenciesDragged: discretionAgenciesDraged
adequatelyConsiderableCompared: adequatelyConsiderableComppared adequatelyConsiderableCompased
bicycleAccordingSufficient: bicycleAccordingSuficient
speakingDependence: speakingDependance
collateMonitoringEmployed: collateMonitoringEmploied
virtuallySeenResulting: virtuallySeenReulting
announcementNature: announcementNatior
considerableMagnificentVariety: considerableMagnificentVariatry
meansTransferredUnion: meansTransferredUnioun
meanResolvedWhereas: meanResolvedWheras
southernSurroundingsExcept: southernSurroundingsExcxept
annualAnalysing: annualAalysing
cemeteryTogether: cemeteryTogehter
subtractApplicableAccept: subtractApplicableAcept
establishingAdaptable: establishingAdabtable
expansionAdvantageousShortened: expansionAdvantageousShortend
possibleScissorsApplied: possibleScissorsUpplied
describedBuildingStomach: describedBuildingStomac describedBuildingStomache describedBuildingStomec describedBuildingStumache
whereasAllowPoetry: whereasAllowPoartry whereasAllowPoertry whereasAllowPoetre whereasAllowPoety whereasAllowPowetry
natureDesiccateDefinitely: natureDesiccateDefinately natureDesiccateDifinately
extremelyThroughoutInconceivable: extremelyThroughoutInconcievable
readjustedSplendidDecides: readjustedSplendidDescides
graphicallyDemandsArguing: graphicallyDemandsAurguing
utilizedStopped: utilizedStoped
declarationsPatternsCompletely: declarationsPatternsCompletly
februaryDecision: februaryDescisions februaryDescision
briefLieuMeans: briefLieuMeens
experienceCollateAllow: experienceCollateAlow
wantedTheir: wantedTher
busyAcceptedArrangement: busyAcceptedArrangment
howeverAunt: howeverAnnt howeverAnut
weaponsQualitiesLatest: weaponsQualitiesLates weaponsQualitiesLatets weaponsQualitiesLatiest weaponsQualitiesLatist
examineConsistPrepared: examineConsistPrepaired
occurredExpense: occurredExpence
responsibilitiesEmployees: responsibilitiesEmploies
whetherNowReceive: whetherNowRecieve
buildDragged: buildDraged
guidelinesWereConsiderable: guidelinesWereConciderable
arrangementProfitsAccessibility: arrangementProfitsAccessability
thereCommercial: thereComersial
receiveSafeguardAggravating: receiveSafeguardAgravating
visitorsVisitedContented: visitorsVisitedContenpted visitorsVisitedContende visitorsVisitedContentid
financiallyExactlyThrough: financiallyExactlyThrout
adaptableShortened: adaptableShortend
transactionsAccountMinutes: transactionsAccountMuinets
receivesAbilityVisited: receivesAbilityFisited receivesAbilityViseted receivesAbilityVistid receivesAbilityVistied
hierarchyNumbersStudents: hierarchyNumbersStudens
comparisonDefinitionsDemands: comparisonDefinitionsDiemands
thoughtsHierarchyBetween: thoughtsHierarchyBeetween
assessingConceivedOrdinary: assessingConceivedOrdenary
theyAssessing: theyAccesing
challengesBenefits: challengesBenifits
beforeSubsequent: beforeSubsequant beforeSubsiquent
operatorParticularComponent: operatorParticularComponant
neitherConsiderRepresentative: neitherConsiderRepresentitive
cancellationAgain: cancellationAgiin
regainedClerkOpinion: regainedClerkOppinion
flexibleNationallyRemember: flexibleNationallyRember flexibleNationallyRemeber flexibleNationallyRememmer flexibleNationallyRermember
suitedProjects: suitedProjeccts
experiencePatterns: experiencePattarns
interpretationThrough: interpretationThrout
componentWroteHowever: componentWroteHoweverr
minutesComposedInitials: minutesComposedInetials minutesComposedInistals minutesComposedInitails minutesComposedInitals minutesComposedIntials
opinionAccessibilityLiterature: opinionAccessibilityLitriture
whetherGeographically: whetherGoegraphicaly
definitionsDependenceAcademically: definitionsDependenceAcademicly
draggedDifficultyDescription: draggedDifficultyDesription draggedDifficultyDescvription draggedDifficultyDesacription
immediateOutputProjects: immediateOutputProjeccts
employmentArguing: employmentAurguing
speakingClerk: speakingCleark speakingClerck
relativelyArranged: relativelyAranged relativelyArrainged
studyingSense: studyingSence
scarcelyRecently: scarcelyReciently
careerCemeteryVoluntary: careerCemeteryVolantry
receiveProportions: receiveProprtions
pleasantInitialsExtremely: pleasantInitialsExtreamly
assessingAppreciated: assessingApreciated
centrallyAnnoyingProportions: centrallyAnnoyingProprtions
annoyingDefinitions: annoyingDefenitions
cakeRelativelyEmbarrass: cakeRelativelyEmbaras cakeRelativelyEmbarass
specialOrdinary: specialOrdenary
completelyWereWrote: completelyWereWote completelyWereWroote
readjustedValuableDecision: readjustedValuableDescisions readjustedValuableDescision
eventuallyEmbellishingGuidelines: eventuallyEmbellishingGuidlines
hierarchyProfitsInitial: hierarchyProfitsIntial
employmentUnderstandRequested: employmentUnderstandRquested
compareCombineCorrespondence: compareCombineCorrespondance
examinationPurpleUniversally: examinationPurpleUniversaly
levelsTheseInteresting: levelsTheseIntresting
conditioningRemember: conditioningRember conditioningRemeber conditioningRememmer conditioningRermember
poemGraphically: poemGraphicaly
valuablePrimarily: valuablePimarily
arguingPronunciation: arguingPronounciation
favourableArgument: favourableAurgument
embellishingParametersAdvantageous: embellishingParametersAdvantageos
earliestDisciplineBusy: earliestDisciplineBuisy
particularVoluntarySupervision: particularVoluntarySupervison
controlledProportionsProgression: controlledProportionsProgresion
resolvedSuffering: resolvedSuufering
magnificentEconometricAvailability: magnificentEconometricAvaiblity
conditioningMonths: conditioningMonthes
priorManuallyGallery: priorManuallyGalery priorManuallyGallary priorManuallyGallerry priorManuallyGallrey
universityData: universityDsata
decideAddressableBeginning: decideAddressableBegining
assessingLater: assessingLaer
necessityWeightedFamiliar: necessityWeightedFamiler
setPerApparent: setPerApparant
wantedAllowResolved: wantedAllowResoved
southernArrangedSubsequent: southernArrangedSubsequant southernArrangedSubsiquent
whereasChoosing: whereasChosing
profitsSheetsPivoting: profitsSheetsPivting
theseProvisoExpense: theseProvisoExpence
rememberRefreshment: rememberReafreshment rememberRefreshmant rememberRefresment rememberRefressmunt
aggravatingEmbarrass: aggravatingEmbaras aggravatingEmbarass
baseReaching: baseReching
similarExcessively: similarExessively
governmentReceipt: governmentReceit governmentReceite governmentReciet governmentRecipt
handleClericalRepetitive: handleClericalRepetative
expenseWereTable: expenseWereTasble
techniquesAccumulatedSeparate: techniquesAccumulatedSeperate
componentCentrallyInvestigated: componentCentrallyInvestegated
laughAgencies: laughAgences
searchAnalysis: searchAnaliss searchAnalsis searchAnalisis
equalledPermanent: equalledPerminant
meantAwful: meantAwfall meantAfful
accommodationDefinitelyAppeal: accommodationDefinitelyApeal
suitedPlannedVariant: suitedPlannedVairiant
suggestionFeelingUnique: suggestionFeelingUneque
minutesPretend: minutesPertend minutesProtend minutesPrtend minutesPritend
universityAccessing: universityAccesing
analysisTransactionsComparison: analysisTransactionsComparrison
misleadingDecided: misleadingDescided
allowSet: allowSettt
assessingScissorsEconometric: assessingScissorsEconomtric
controlledCorporate: controlledCorparate
collateMonitoring: collateMonitering
operationsFlexible: operationsFlexable
personnelParticular: personnelPaerticulaur
bonusFalseOperator: bonusFalseOpertor
monthsSimilarDoubt: monthsSimilarDoupt
drivenReceivingIntelligence: drivenReceivingInteligence
successiveHierarchical: successiveHierachial
familiesThereTransportability: familiesThereTransportibility
ordinaryTheseChoice: ordinaryTheseChoise
availableCommercialNegligible: availableCommercialNegligable
annualProvisoScarcely: annualProvisoScarcly annualProvisoScarecly annualProvisoScarely annualProvisoScarsely
abilityAvailable: abilityAvaible
understandableSeparation: understandableSeperation
proportionsConverselyRecommend: proportionsConverselyRecomend
referenceIrrelevant: referenceIrrelavent
erroneousMeant: erroneousMent
standardizingTheyProgresses: standardizingTheyProgressess
arguingCompare: arguingCompair
resolvedAccessibilityNationally: resolvedAccessibilityNationaly
busyParticular: busyParticulaur
comparedExcessivelyReadjusted: comparedExcessivelyReajusted
availableLuckily: availableLuckeley
professionBenefitParallel: professionBenefitParalel professionBenefitParalell professionBenefitParrallel professionBenefitParralell professionBenefitParrallell
approximatelyDecides: approximatelyDescides
clericalPermanentFalse: clericalPermanentFaulse
interpretationAppointmentDifficulty: interpretationAppointmentDificulty
diagrammaticallyLonelyConference: diagrammaticallyLonelyConferance
minutesSurroundingAssociated: minutesSurroundingAssosiated
definitionsThere: definitionsTher
availableOften: availableOfen availableOffen availableOfften availableOfton
collateReceive: collateRecieve
transportabilityAbility: transportabilityAblity
recommendingTheyEasily: recommendingTheyEasyly
luckilyOrganization: luckilyOranisation luckilyOragnisation
separateExpansion: separateExpanion
opinionCommentsBelieve: opinionCommentsBelive
betweenEconometric: betweenEconomtric
beneficialBenefitsAdaptable: beneficialBenefitsAdabtable
desiccateSouthern: desiccateSouthen
personnelAccumulatedOften: personnelAccumulatedOfen personnelAccumulatedOffen personnelAccumulatedOfften personnelAccumulatedOfton
anomaliesNow: anomaliesNaaw
doubtClerical: doubtClearical
primarilyHierarchyExtremely: primarilyHierarchyExtreemly
unnecessaryQualities: unnecessaryQuaties
standardizingPlanned: standardizingPlannned
operationsDependenceExecuted: operationsDependenceExecutted
agenciesThereAppreciation: agenciesThereApreciation
familiarRecentlyBonus: familiarRecentlyBonas
referredUtilizedEarliest: referredUtilizedEarlyest
pronunciationCommittees: pronunciationComittees pronunciationCommitees
laughManagement: laughManagment
particularPossibilitiesUnresolved: particularPossibilitiesUnresloved
nationallyRegisterPossibilities: nationallyRegisterPossablities
qualitiesCancellation: qualitiesCancelation
thoughtsLevels: thoughtsLevaals
referredExpansionSuited: referredExpansionSuted
provisoEmbellishing: provisoEmbelishing
similarGovernment: similarGoverment
careersIndeed: careersIndead
understandScrutinized: understandScrutiniesed
availableSpeaking: availableSpeeking
pronunciationInitials: pronunciationInetials pronunciationInistals pronunciationInitails pronunciationInitals pronunciationIntials
equalledExtremelyDeclarations: equalledExtremelyDeclaratrions
speakingSuccessiveHierarchy: speakingSuccessiveHeiarky
initialDisappointingUniversity: initialDisappointingUnversity
thereBeneficial: thereBenificial thereBenficial
variableUnexpected: variableUnexpcted variableUnexpeted variableUnexspected
initialsPoem: initialsPoame
expansionNightUnderstandable: expansionNightUnderstadable
someonePossibilitiesWhen: someonePossibilitiesWenn
particularJuiceGraphically: particularJuiceGraphicaly
magnificentAlthoughAnalysing: magnificentAlthoughAalysing
biscuitsBuildSuggestion: biscuitsBuildSugestion
combineSomeone: combineSomone
locallySurveying: locallyServaying
containingWould: containingWhould
appealApparent: appealApparant
routineSupplementary: routineSuplementary
flexibleArrangement: flexibleArragment
levelDoubt: levelDoupt
weaponsEliminatedAppointments: weaponsEliminatedApointments
sensibleSafeguard: sensibleSafegaurd
doubtNecessitates: doubtNessisitates
understandableSeniorResponsibilities: understandableSeniorResponsiblities
thereInconceivable: thereInconcievable
seniorSeenValuable: seniorSeenValubale seniorSeenValuble
thereforeRecommend: thereforeRecomend
tableAnnualSupposedly: tableAnnualSupposidly
securityManuallyTitles: securityManuallyTitttles
whetherExpenseNecessitates: whetherExpenseNessisitates
preparedAssociated: preparedAssosiated
surroundingProviso: surroundingProvisoe
sufferingLatestWould: sufferingLatestWhould
variantFeeling: variantFealing
decisionEmployment: decisionEmpolyment
drasticallyProfession: drasticallyPreffeson
proceedingBrief: proceedingBrif
supervisionManyHierarchy: supervisionManyHierchy
permanentlyAccountMajority: permanentlyAccountMajorty
similarInquiries: similarEquiries
inquiriesEmbarrassClerical: inquiriesEmbarrassClearical
arrangedCompared: arrangedComppared arrangedCompased
doubtSubsequentVariable: doubtSubsequentVarable
pivotingFeelingFlexible: pivotingFeelingFlexable
employmentForbiddenPermanent: employmentForbiddenPerminant
meanThese: meanThess
refreshmentScheme: refreshmentScheem
experienceInterpretationProfit: experienceInterpretationProffit
hierarchicalAcceptBefore: hierarchicalAcceptBefor
demandsRepetitive: demandsRepetative
conditioningSeparate: conditioningSeperate
operationsCertainData: operationsCertainDsata
primarilyExperiencesReference: primarilyExperiencesRefereence primarilyExperiencesRefference
refreshmentBuildingSuccessive: refreshmentBuildingSucsesive refreshmentBuildingSucessive
variousSufficientNumbers: variousSufficientNumbuers
questionnaireNegligiblePlanned: questionnaireNegligiblePlannned
permanentDissension: permanentDesention
declarationsComparison: declarationsComparrison
considerableRoutineGaining: considerableRoutineGaning
accordingInitial: accordingIntial
votingRequired: votingReequired
conceivedErroneousSouthern: conceivedErroneousSouthen
laterOutput: laterOputput
questionnaireEliminatedPersonnel: questionnaireEliminatedPersonel
separateUnfortunatelyFamilies: separateUnfortunatelyFamiles
componentArrangements: componentAraingements
draggedResolved: draggedResoved
purpleAppointmentDescription: purpleAppointmentDiscription
recommendApparentIrrelevant: recommendApparentIrrelavent
associatedUniversallyUnnecessarily: associatedUniversallyUnessasarily
accountAlthough: accountAthough
arrangementConsiderableFunctionally: arrangementConsiderableFunctionaly
oppositeExamine: oppositeExamin
basicallyUnresolvedParticularly: basicallyUnresolvedParticulary
unionThroughoutParameters: unionThroughoutPerametres
arrangementIntelligence: arrangementInteligence
routineAccessEstablishing: routineAccessAstablishing routineAccessEstablising
irrelevantInterpretationConfirmation: irrelevantInterpretationConfermation
acquaintancesVariable: acquaintancesVarible acquaintancesVaiable
questionnaireSpeakingDevelop: questionnaireSpeakingDevelope
believeApplicableVoluntary: believeApplicableVolantary
announcementEstablishingUmbrella: announcementEstablishingUmberalla
occurrenceContinuedBrief: occurrenceContinuedBrif
reachingAwfulBenefit: reachingAwfulBenifit
variantInterest: variantIntrest
difficultDifferent: difficultDiffrent
adaptableFalseApproximately: adaptableFalseAproximatly
embellishingGenevaThere: embellishingGenevaThear
executedMisleading: executedMissleading
combineSurroundings: combineSuroundings combineSeroundings
standardizingRemind: standardizingRemine standardizingRemined
argumentLieu: argumentLiew
oftenTherefore: oftenTherefoe
investigatedDevelop: investigatedDevelope
wroteDraggedSpecial: wroteDraggedSpeaical wroteDraggedSpecail wroteDraggedSpecal wroteDraggedSpeical
inefficientInvestigated: inefficientInvestegated
initialsBiscuitsParticular: initialsBiscuitsParticulaur
dissensionAnnoying: dissensionAnoying
careerAnalysisErroneous: careerAnalysisErrounous
particularExtremely: particularExtreemly
reallySecurityUnfortunately: reallySecurityUnfortunatly
stomachImmediate: stomachImediate
applicableUnequivocallyAnnouncing: applicableUnequivocallyAnouncing
successiveSuggestion: successiveSugestion
definitelyHierarchy: definitelyHierchy
earliestWere: earliestWeree
profitsVisited: profitsFisited profitsViseted profitsVistid profitsVistied
necessaryControlled: necessaryControled
lieuChoice: lieuChoise
atmosphereUnnecessarily: atmosphereUnessasarily
singularSummariesInconvenient: singularSummariesInconvienient singularSummariesInconvient singularSummariesInconvinient
considerCombine: considerComibine
interrogatingDesiccateDecisions: interrogatingDesiccateDeciscions interrogatingDesiccateDescisions
earliestHowever: earliestHoweverr
unequalledProcedure: unequalledProceduer
applicableAdvantageousBuilding: applicableAdvantageousBiulding
throughSuitedLonely: throughSuitedLonley
adaptableProgresses: adaptableProgressess
demandsQualitiesPermanently: demandsQualitiesPerminantly
transactionsEssentialQueries: transactionsEssentialQuies
accountsAssociatedBuilt: accountsAssociatedBiult
bicycleChapterMisleading: bicycleChapterMissleading
extremelyExponentially: extremelyExponentualy
arrangementsSingularUseful: arrangementsSingularUsful
collateReceivesPrimarily: collateReceivesPimarily
liaisonInputReceiving: liaisonInputRecieving liaisonInputReciving
shownTechnique: shownTecnique
doubtTitles: doubtTitttles
appointmentCreditShown: appointmentCreditHown
certainDescribedLater: certainDescribedLaer
segmentSubtract: segmentSubtrcat
parametersAgenciesAccounts: parametersAgenciesAcounts
embarrassSufficient: embarrassSuficient
necessityPrior: necessityPiror
decisionFebruary: decisionFebuary
surveysContaining: surveysContaing
thereWanted: thereWantid
familiarTogetherUnavailable: familiarTogetherUnavailble
arguingPoetry: arguingPoartry arguingPoertry arguingPoetre arguingPoety arguingPowetry
unexpectedFamilies: unexpectedFamilys
outputAnomaliesParticular: outputAnomaliesPaerticulaur
comparisonContinually: comparisonContually
clerkBuilding: clerkBiulding
andNegligibleWeapons: andNegligibleWepons
splendidAppliedInterpretation: splendidAppliedInterpritation
associatedComparisonAdequate: associatedComparisonAdiquate
considerUtilized: considerUtalised
arrangingChoiceAccount: arrangingChoiceAcount
numbersChapter: numbersChaper numbersChaphter numbersChaptur
executedRegainedAcquaintances: executedRegainedAquantences
setVariety: setVariatry
yearsSupposedlyRegister: yearsSupposedlyRgister
senseDifferentPoems: senseDifferentPoims senseDifferentPomes
wroteOperations: wroteOperatins
operationsProfessionNeither: operationsProfessionNiether
requestedVoting: requestedVoteing
similarSingular: similarSingulaur
triangularFebruaryWill: triangularFebruaryWilll
applicableThroughout: applicableThrouout
surveyingHoweverChoosing: surveyingHoweverChosing
requestedVisitors: requestedVistors
adequatelyCemeteryThoughts: adequatelyCemeteryThorts
favourableAccepted: favourableAcepted
correspondenceHierarchicalSpeaking: correspondenceHierarchicalSpeeking
disciplineInterrogating: disciplineInterogationg
availableApproached: availableAproached
aggravatingConditioningMonitoring: aggravatingConditioningMonitering
manyFeelingWanted: manyFeelingWantid
rememberAppointments: rememberApointments
certainSessionQualities: certainSessionQuaties
addressableAdequateSenior: addressableAdequateSienior
minutesMonthsOrientated: minutesMonthsOrentated
supplementaryUsefulGenerated: supplementaryUsefulGenerataed
accessingTableAdjournment: accessingTableAdjurnment
believeCredit: believeCreadit
variableMeansWhether: variableMeansWether
thereSearch: thereSerch
remindRelevant: remindRelavent remindRelevaant
employmentLocally: employmentLocaly
virtuallyConference: virtuallyConferance
unionRepresentative: unionRepresentitive
particularlyForbidden: particularlyForbiden
consistingComposed: consistingCompossed
segmentCorrespondenceArticles: segmentCorrespondenceArticals
visitorsUnderstandable: visitorsUnderstadable
draggedUnderstand: draggedUndersand draggedUndistand
exceptBusyCredit: exceptBusyCreadit
accessControlledArrangements: accessControlledAraingements
exactlyGeneva: exactlyGeniva
poetryProjectsEmployment: poetryProjectsEmpolyment
drasticallyAnalyse: drasticallyAnaliss
minutesConfirmation: minutesConfermation
cancellationLonelyScheme: cancellationLonelyScheem
searchSurveys: searchServays
falseCareerComposed: falseCareerCompossed
decideDesperately: decideDespratly
unequalledSystem: unequalledSysem
priorTable: priorTasble
certainCurrentlyTherefore: certainCurrentlyTherefoe
containingDrivenCriticism: containingDrivenCitisum
decideMeansMathematically: decideMeansMathematicaly
relevantVirtually: relevantVertually
examineProfitAunt: examineProfitAnnt examineProfitAnut
acceptConfirmationChoices: acceptConfirmationChoises
certainAddress: certainAdress certainAdres
addressRoutineDecided: addressRoutineDescided
andBenefit: andBenifit
correspondenceBonus: correspondenceBonas
recommendingAppreciatedDesiccate: recommendingAppreciatedDesicate recommendingAppreciatedDessicate recommendingAppreciatedDessiccate
separateVariant: separateVairiant
arrangementSeenBenefits: arrangementSeenBenifits
particularCurrentlyLength: particularCurrentlyLengh
transferredUniversally: transferredUniversaly
ordinaryBuildingAssessing: ordinaryBuildingAccesing
geographicallyUnnecessarilyConditioning: geographicallyUnnecessarilyConditining
inconvenientTransportability: inconvenientTransportibility
regainedBetweenVirtually: regainedBetweenVertually
unexpectedAccountSurveying: unexpectedAccountServaying
consistingInquiriesFamilies: consistingInquiriesFamilys
receivesAvailable: receivesAvailble
referenceWeightedFails: referenceWeightedFailes
adaptableReceiving: adaptableRecieving adaptableReciving
basicallyConditioning: basicallyConditining
unequivocallyLocallyUseful: unequivocallyLocallyUsefull
variableConsisting: variableConsisiting
hierarchyReferenceRelevant: hierarchyReferenceRelavent hierarchyReferenceRelevaant
ideallyInconceivableMinuscule: ideallyInconceivableMiniscule
unnecessarilyBeginningDecide: unnecessarilyBeginningDescide
considerableAcademically: considerableAcademicly
approachedSeenProvide: approachedSeenProvid
immediateMean: immediateMeen
eliminatedArrangement: eliminatedArrangment
doubtCommittee: doubtCommitte
basicallyDifficult: basicallyDificult
indeedSuccessive: indeedSucsesive indeedSucessive
beforeSetAccording: beforeSetAcording
gainingWroteAre: gainingWroteArre
acceptOverallEnormously: acceptOverallEnomosly
forecastStandardizing: forecastStanerdizing
auntConfirmationAgencies: auntConfirmationAgences
pretendApproachedExactly: pretendApproachedExsactly
desiccateAppreciation: desiccateApreciation
matrixDescription: matrixDiscription
unavailableFamiliar: unavailableFamiler
builtDiscretion: builtDiscresion
beforeThey: beforeThay
reallyPermanently: reallyPerminantly
governmentOpposite: governmentOpisite governmentOppasite governmentOppesite governmentOppisit governmentOppisite governmentOpposit governmentOppossite governmentOppossitte
separationAppointmentQuestionnaire: separationAppointmentQuestionaire
organizedRequested: organizedRquested
acceptExplainingLiaison: acceptExplainingLiaision acceptExplainingLiason
bicyclePronunciationEcstasy: bicyclePronunciationExstacy bicyclePronunciationEcstacy
cancellationSenseApologised: cancellationSenseAppologised
completelyAnomaliesProblem: completelyAnomaliesProblam completelyAnomaliesProble completelyAnomaliesPromblem completelyAnomaliesProplen
declarationsSenseRequired: declarationsSenseReequired
suggestedFeelingAccessing: suggestedFeelingAccesing
assessingAcceptedSafeguard: assessingAcceptedSafegaurd
combinePossibilitiesSensible: combinePossibilitiesSensable
extendedAgainLaugh: extendedAgainLagh extendedAgainLauf extendedAgainLaught extendedAgainLuggh
securityAuxiliary: securityAuxillary
eliminatedSurroundingsOutput: eliminatedSurroundingsOputput
misleadingFeelingSurrounding: misleadingFeelingSerounding
purpleWrote: purpleWote purpleWroote
desperatelyExecuted: desperatelyExecutted
supplementaryConsiderable: supplementaryConciderable
erroneousBiscuitsApproach: erroneousBiscuitsAproach
studyingAdequately: studyingAdequattly
matrixBeginning: matrixBegining
difficultySources: difficultySorces
comparisonChoices: comparisonChoises
disciplineGovernmentRoutine: disciplineGovernmentRouint
beginningLatest: beginningLates beginningLatets beginningLatiest beginningLatist
articlesDiscipline: articlesDisiplin
approachedSupposedlySeparate: approachedSupposedlySeporate
shortenedEliminated: shortenedElimiated
areAnnouncing: areAnouncing
scrutinizedChallenge: scrutinizedChalange
econometricDesiccate: econometricDesicate econometricDessicate econometricDessiccate
obtainingTotallyCareer: obtainingTotallyCarear
unexpectedPurpleContinually: unexpectedPurpleContually
transportabilityAnomalies: transportabilityAnomolies
usefulOccurred: usefulOccureed
laughBicycle: laughBicycal laughBycicle laughBycycle
accessManyAppointment: accessManyAppoitment
professionWouldImmediate: professionWouldImediate
securityCommitteesThroughout: securityCommitteesThrouout
setDecide: setDescide
someoneInterestingVoting: someoneInterestingVoteing
considerCareer: considerCarear
definitionProportionsJournalism: definitionProportionsJournaism
appealOperator: appealOpertor
securityAdequateOperations: securityAdequateOperatins
drivenPersonnel: drivenPersonnell
interpretationFalseAnnoying: interpretationFalseAnoying
eliminatedSafeguardConversely: eliminatedSafeguardConversly
functionallyConceivedStandardizing: functionallyConceivedStanerdizing
personnelAuxiliaryLevel: personnelAuxiliaryLevaal
locallyPoemsMagnificent: locallyPoemsMagnificnet locallyPoemsMagificent locallyPoemsMagnifcent locallyPoemsMagnifecent locallyPoemsMagnifiscant locallyPoemsMagnifisent locallyPoemsMagnificant
splendidOpinion: splendidOppinion
nightDemands: nightDiemands
southernWeighted: southernWagted
cakeEmployed: cakeEmploied
apparentChoicesMonths: apparentChoicesMonthes
arrangingAccumulated: arrangingAcumulated
availableContainingExcessively: availableContainingExessively
auxiliaryVarietyHandle: auxiliaryVarietyHandell
unionPriorAccommodation: unionPriorAccomodation unionPriorAcommodation unionPriorAcomodation
variableSpeakingIndeed: variableSpeakingIndead
plannedCriticismFeeling: plannedCriticismFealing
acquaintancesFavourableUnderstand: acquaintancesFavourableUndersand acquaintancesFavourableUndistand
titlesUnavailable: titlesUnavailble
voluntaryAgenciesTogether: voluntaryAgenciesTogehter
argumentAnalysed: argumentAnalised
proceedingSafeguardVisitor: proceedingSafeguardVistor
embarrassAlthoughEliminated: embarrassAlthoughElimiated
searchMinutes: searchMuinets
decidedAccessibilityRefreshment: decidedAccessibilityReafreshment decidedAccessibilityRefreshmant decidedAccessibilityRefresment decidedAccessibilityRefressmunt
favourableRemindRelatively: favourableRemindRelativly favourableRemindRelitivly
hierarchyWhen: hierarchyWenn
arguingRelatively: arguingRelativly arguingRelitivly
sheetsGenerated: sheetsGenerataed
minutesConditioningYears: minutesConditioningYesars
bonusComments: bonusComents
visitedRelativelyWidely: visitedRelativelyWidly
conceivedOppositeDesperately: conceivedOppositeDespratly
ordinaryPatternsSegment: ordinaryPatternsSegemnt
handleCriticism: handleCitisum
umbrellaChapterPerhaps: umbrellaChapterPerhapse
summariesProgression: summariesProgresion
interestingUnequivocallyAddressable: interestingUnequivocallyAddresable
decisionResponsibilities: decisionResponsiblities
clericalBetweenInterest: clericalBetweenIntrest
accommodationRecentlyRecently: accommodationRecentlyReciently
willExamination: willEximination
extremelyWroteApproached: extremelyWroteAproached
supposedlyEconometricForbidden: supposedlyEconometricForbiden
comparisonThoughtsDefinition: comparisonThoughtsDefenition
separateCommitteeMatrix: separateCommitteeMatriiix
techniqueCurtains: techniqueCartains techniqueCertans techniqueCourtens techniqueCuaritains techniqueCurtans techniqueCurtians techniqueCurtions
establishingConferenceOverall: establishingConferenceOveral
pronunciationUnresolved: pronunciationUnresloved
erroneousUnique: erroneousUneque
sheetsRegisterTransferred: sheetsRegisterTransfred
particularTransactions: particularTrasactions
anomaliesNeither: anomaliesNiether
correspondenceLonely: correspondenceLonley
positionPriorMean: positionPriorMeen
investigatedExperiencesVarious: investigatedExperiencesVairious
manuallyPatternsReferred: manuallyPatternsRefered manuallyPatternsReffered
personnelRequiredAlthough: personnelRequiredAthough
annoyingWill: annoyingWilll
betweenDefinition: betweenDefenition
decisionsAccounts: decisionsAcounts
academicallyUnnecessarilySecurity: academicallyUnnecessarilySeurity
widelyStomach: widelyStomac widelyStomache widelyStomec widelyStumache
summariesRecommending: summariesRecomending
flexibleInconvenientSet: flexibleInconvenientSettt
theseLength: theseLengh
committeeFeelingCommittee: committeeFeelingComittee
awfulMathematically: awfulMathematicaly
necessityEncourage: necessityEncorage
hierarchyRelevantSeparated: hierarchyRelevantSeperated
scrutinizedOverall: scrutinizedOveral
employeesWithinWere: employeesWithinWeree
graphicallySuited: graphicallySuted
usefulSuccessful: usefulSucssuful usefulSuccesful
studentsWhether: studentsWether
transportabilityAndCommit: transportabilityAndComit
clerkInterestBase: clerkInterestBasse
virtuallyObtaining: virtuallyOptaning
techniquesCorporateAppreciated: techniquesCorporateApreciated
appointmentOperatorExtended: appointmentOperatorExtented
analyseProcedureBicycle: analyseProcedureBicycal analyseProcedureBycicle analyseProcedureBycycle
completelyMajority: completelyMajorty
searchProgressionAddress: searchProgressionAdress searchProgressionAdres
opinionSegmentSurroundings: opinionSegmentSuroundings opinionSegmentSeroundings
comparisonYearsVariable: comparisonYearsVarible comparisonYearsVaiable
applicableAccept: applicableAcept
especiallySuccessfulQuestionnaire: especiallySuccessfulQuestionare
exactlyPretendUtilized: exactlyPretendUtalised
movingParameters: movingPerametres
analysingAdvantageousObtaining: analysingAdvantageousOptaning
correspondenceNecessary: correspondenceNeccesary correspondenceNecesary correspondenceNecassary correspondenceNecassery correspondenceNeccasary
singularDisappointing: singularDissapoiting
encourageJuice: encourageGuic encourageJuce encourageJucie encourageJuise encourageJuce
abilityBenefitCompare: abilityBenefitCompair
remindReceives: remindRecives remindRecieves
receiptAtmospherePrior: receiptAtmospherePiror
forecastAccess: forecastAcess
universallyPermanentlyChallenge: universallyPermanentlyChalange
adjournmentExcept: adjournmentExcxept
literatureArticles: literatureArticals
projectsUsefulPurple: projectsUsefulPerple projectsUsefulPerpul projectsUsefulPoarple
natureSplendidScrutinized: natureSplendidScrutiniesed
contentedContainingFebruary: contentedContainingFebuary
registerAddressable: registerAddresable
consistingDesperatelyProfession: consistingDesperatelyPreffeson
examinationWantedUnequivocally: examinationWantedUnequivocaly
liaisonApproximately: liaisonAproximatly
conceivedBuiltAnalysis: conceivedBuiltAnaliss conceivedBuiltAnalsis conceivedBuiltAnalisis
feelingQuestionnaireBeginning: feelingQuestionnaireBegining
althoughCareers: althoughCurrers althoughCarrers
feelingSourceBasically: feelingSourceBasicaly
econometricComponent: econometricComponant
purpleConceived: purpleConcieved
misleadingGuidelinesReceive: misleadingGuidelinesRecieve
varietyCommit: varietyComit
transportabilityWereSuffering: transportabilityWereSuufering
thereforeUnionSimilar: thereforeUnionSimular
earliestAre: earliestArre
chapterDefinitionDiagrammatically: chapterDefinitionDiagrammaticaally
understandAtmosphereExpansion: understandAtmosphereExpanion
experiencesInefficient: experiencesIneffiect
understandGaining: understandGaning
erroneousDependencePosition: erroneousDependencePossition
differentUnequivocallySomeone: differentUnequivocallySomone
extremelySensePronunciation: extremelySensePronounciation
theyStudying: theyStuding
requiredShown: requiredHown
appointmentVariable: appointmentVarable
inconceivableCertain: inconceivableCirtain
accountsExperiences: accountsExperances
intelligenceAvailabilitySource: intelligenceAvailabilitySorce
thereforeFurtherTriangular: thereforeFurtherTriangulaur
setInconvenientAccess: setInconvenientAcess
thereforeApplied: thereforeUpplied
careerReferred: careerRefered careerReffered
continuedDraggedDiscipline: continuedDraggedDisiplin
thereDisappointingDifficult: thereDisappointingDificult
opinionThroughExamine: opinionThroughExamin
parametersSimilar: parametersSimular
traditionallyEncompassing: traditionallyEncompasing
whetherTriangular: whetherTriangulaur
representativePosition: representativePossition
unnecessarilyPrepared: unnecessarilyPrepaired
anomaliesPerCentrally: anomaliesPerCentraly
draggedGeneratedCommercial: draggedGeneratedComersial
initialForbiddenSense: initialForbiddenSence
doubtFailsLocally: doubtFailsLocaly
failsReadjusted: failsReajusted
analyseDrasticallySingular: analyseDrasticallySingulaur
approachInterpretationLoans: approachInterpretationLones
drasticallyApologies: drasticallyAppologies
personnelLatestDefinitions: personnelLatestDefenitions
definitionsFails: definitionsFailes
personnelDriven: personnelDirven
centrallyCentrallyOccurrence: centrallyCentrallyOccurence
forecastMajorityExplaining: forecastMajorityExplaning
buildSpecial: buildSpeaical buildSpecail buildSpecal buildSpeical
aggravatingSessionInterrogating: aggravatingSessionInterogationg
shortenedCentrally: shortenedCentraly
employmentMinutes: employmentMuinutes employmentMuiuets
demandsExtremely: demandsExtreamly
ordinarySupposedly: ordinarySupposidly
unionCollateAnalysed: unionCollateAnalised
applicableTogetherDiscretion: applicableTogetherDiscresion
meansAdjournment: meansAdjurnment
transferredSensible: transferredSensable
orientatedMinusculeAvailable: orientatedMinusculeAvailble
widelySeen: widelySeeen
universallyEspecially: universallyEspecaily
forecastRoutine: forecastRouint
examinationUsefulApplicable: examinationUsefulAplicable
specialWeightedCommittees: specialWeightedComittees specialWeightedCommitees
negligibleLoans: negligibleLones
understandableSupersede: understandableSupercede understandableSuperceed
variableSingularNecessity: variableSingularNessesity
whenDrasticallyApologies: whenDrasticallyAppologies
manuallyAccompanying: manuallyAcompaning
theyRegister: theyRgister
throughoutBelieveSystem: throughoutBelieveSysem
separateProvideEventually: separateProvideEventully
difficultyDataOpportunity: difficultyDataOppertunity difficultyDataOppotunity difficultyDataOpperttunity
apologiesIdeally: apologiesIdealy
monthsUnequivocally: monthsUnequivocaly
operatorScrutinizedDriven: operatorScrutinizedDirven
correspondenceWouldPoem: correspondenceWouldPoame
occurrenceEssential: occurrenceEsential
arrangedNatureProfits: arrangedNatureProffits
hierarchicalDescribed: hierarchicalDiscribed hierarchicalDescribd
scrutinizedNecessaryAccompanying: scrutinizedNecessaryAcompaning
requiredDrastically: requiredDrasticaly
graphicallyIndependent: graphicallyIndependant
procedureProblem: procedureProblam procedureProble procedurePromblem procedureProplen
visitorCurrentlyNature: visitorCurrentlyNatior
obtainingProblemOrganization: obtainingProblemOranisation obtainingProblemOragnisation
triangularSegment: triangularSegemnt
beginningAppointment: beginningAppoitment
luckilyAllow: luckilyAlow
examinationImmediatelyConsider: examinationImmediatelyConcider
transportabilityInteresting: transportabilityIntresting
sheetsManually: sheetsManualy
baseNumbers: baseNumbuers
poemWhereas: poemWheras
interestEmbarrassEncourage: interestEmbarrassEncorage
executedMatrix: executedMatriiix
acceptedContented: acceptedContenpted acceptedContende acceptedContentid
visitedProcedureAnnouncement: visitedProcedureAnouncement
overallHierarchy: overallHeiarky
examinationOrganizationExperiences: examinationOrganizationExperances
rememberPoetryProviso: rememberPoetryProvisoe
appliedBelieve: appliedBelive
hierarchicalNationally: hierarchicalNationaly
laterProfitUnnecessary: laterProfitUnessessay
utilizedUnresolvedBuild: utilizedUnresolvedBiuld
unresolvedVoluntary: unresolvedVolantry
separatedTechniques: separatedTecniques
minutesAccount: minutesAcount
juiceDisciplineEmbellishing: juiceDisciplineEmbelishing
basicallyMoving: basicallyMoveing
unfortunatelySegmentUnexpected: unfortunatelySegmentUnexpcted unfortunatelySegmentUnexpeted unfortunatelySegmentUnexspected
experiencesUseful: experiencesUsefull
poetryPrimarilyPossible: poetryPrimarilyPossable
votingApproachedForecast: votingApproachedForcast
disciplineExplaining: disciplineExplaning
withinMinutesReaching: withinMinutesReching
controlledGallery: controlledGalery controlledGallary controlledGallerry controlledGallrey
currentlyOpportunity: currentlyOppertunity currentlyOppotunity currentlyOpperttunity
areHandle: areHandell
supposedlyYears: supposedlyYesars
analysingEdition: analysingEdiion analysingEdiition
varietyEmbarrassDifferent: varietyEmbarrassDiffrent
operationsHierarchySources: operationsHierarchySorces
againTransactionsCurtains: againTransactionsCartains againTransactionsCertans againTransactionsCourtens againTransactionsCuaritains againTransactionsCurtans againTransactionsCurtians againTransactionsCurtions
unequalledGraphicallyAccumulated: unequalledGraphicallyAcumulated
segmentAccessibility: segmentAccessability
thereforeProgressesComments: thereforeProgressesComents
desperatelyDifficulty: desperatelyDificulty
governmentReference: governmentRefereence governmentRefference
oppositeBeforeFavourable: oppositeBeforeFaverable
receiveApologised: receiveAppologised
advantageousTechniqueProceeding: advantageousTechniqueProceding
decisionsFurther: decisionsFuther
inefficientUnnecessarilyNecessary: inefficientUnnecessarilyNecasery inefficientUnnecessarilyNessasary inefficientUnnecessarilyNessisary inefficientUnnecessarilyNeccassary
scissorsLengthCorporate: scissorsLengthCorparate
cemeteryConsist: cemeteryConsisit
referenceConsistingVisitors: referenceConsistingVistors
feelingWhetherDependence: feelingWhetherDependance
literatureOrganized: literatureOranised
appealSupervision: appealSupervison
functionallySenior: functionallySienior
negligibleSurrounding: negligibleSerounding
dataSummaries: dataSumarys
variableMinuscule: variableMiniscule
whenFurtherSheets: whenFurtherSheertes
enormouslyWithin: enormouslyWitin
benefitsArranging: benefitsAranging
summariesScissors: summariesScisors summariesSissors
essentialAlthoughIdeally: essentialAlthoughIdealy
perhapsLaugh: perhapsLagh perhapsLauf perhapsLaught perhapsLuggh
seniorDissensionHierarchical: seniorDissensionHierachial
standardizingMinutesMinutes: standardizingMinutesMuinutes standardizingMinutesMuiuets
bicycleCreditLuckily: bicycleCreditLuckeley
necessaryBusy: necessaryBuisy
failsComposedPleasant: failsComposedPlesent
appreciationNatureThese: appreciationNatureThess
loansWeapons: loansWepons
varietyNecessaryAnalyse: varietyNecessaryAnaliss
approachRoutineWeighted: approachRoutineWagted
pleasantProvide: pleasantProvid
successfulMagnificent: successfulMagnificnet successfulMagificent successfulMagnifcent successfulMagnifecent successfulMagnifiscant successfulMagnifisent successfulMagnificant
containingThere: containingThear
eventuallySpeakingReally: eventuallySpeakingRealy eventuallySpeakingRelley
minusculeDefinitely: minusculeDefinately minusculeDifinately
requestedWouldArgument: requestedWouldAurgument
accountsBuild: accountsBiuld
utilizedDissensionOrganized: utilizedDissensionOranised
decideBefore: decideBefor
apologisedApproximatelyAnnual: apologisedApproximatelyAnual
suggestedExtended: suggestedExtented
desperatelyAdjournmentPretend: desperatelyAdjournmentPertend desperatelyAdjournmentProtend desperatelyAdjournmentPrtend desperatelyAdjournmentPritend
organizedInterpretation: organizedInterpritation
withinProceeding: withinProceding
whetherDeclarations: whetherDeclaratrions
applicableRegained: applicableRegined
laterAccountLevels: laterAccountLevaals
