
AABBs	AABB	NNS
AABB	AABB	NN
AAPTs	AAPT	NNS
AAPT	AAPT	NN
AASM	AASM	NN
abac	abac	NN
ABAP	ABAP	NN
Abaqus	Abaqus	NNP
ABBYY	ABBYY	NNP
ABCpdf	ABCpdf	NNP
Ableton	Ableton	NNP
abtests	abtest	NNS
abtest	abtest	NN
Accel	Accel	NNP
Acceleo	Acceleo	NNP
accumarrays	accumarray	NNS
accumarray	accumarray	NN
Accumulo	Accumulo	NNP
AccuRev	AccuRev	NNP
AChartEngine	AChartEngine	NNP
Ackermann	Ackermann	NNP
ACPI	ACPI	NN
Acquia	Acquia	NNP
ACRA	ACRA	NNP
actionbars	actionbar	NNS
actionbar	actionbar	NN
actionforms	actionform	NNS
actionform	actionform	NN
actionlinks	actionlink	NNS
actionlink	actionlink	NN
ActionPack	ActionPack	NNP
actionviews	actionview	NNS
actionview	actionview	NN
ActiveAndroid	ActiveAndroid	NNP
ActiveJDBC	ActiveJDBC	NNP
ActiveJob	ActiveJob	NNP
ActiveMQ	ActiveMQ	NNP
ActivePerl	ActivePerl	NNP
ActivePython	ActivePython	NNP
ActiveReports	ActiveReports	NNP
ActiveTcl	ActiveTcl	NNP
ActiveWeb	ActiveWeb	NNP
Activiti	Activiti	NNP
Actix	Actix	NNP
Acumatica	Acumatica	NNP
AdaBoost	AdaBoost	NNP
Adafruit	Adafruit	NNP
ADAL	ADAL	NNP
Adblock	Adblock	NNP
AdColony	AdColony	NNP
addons	addon	NNS
addon	addon	NN
adehabitatHR	adehabitatHR	NN
ADempiere	ADempiere	NNP
ADFS	ADFS	NNS
ADFS	ADFS	NN
ADGroup	ADGroup	NNP
adhoc	adhoc	FW
ADLDS	ADLDS	NNS
Adminer	Adminer	NNP
adminhtml	adminhtml	NN
AdminLTE	AdminLTE	NNP
AdMob	AdMob	NNP
ADOdb	ADOdb	NNP
adodbapi	adodbapi	NN
ADOMD	ADOMD	NNP
ADOX	ADOX	NNP
ADPlus	ADPlus	NNP
ADSI	ADSI	NNS
adview	adview	NN
AdWhirl	AdWhirl	NNP
Adxstudio	Adxstudio	NNP
Aero	Aero	NNP
AeroGear	AeroGear	NNP
Aerospike	Aerospike	NNP
Aeson	Aeson	NNP
Affdex	Affdex	NNP
AFNetworking	AFNetworking	NNP
AForge	AForge	NNP
aframe	aframe	NN
AGAL	AGAL	NN
Agda	Agda	NNP
agens	agens	FW
Aginity	Aginity	NNP
agrep	agrep	NN
agsXMPP	agsXMPP	NNP
AIDL	AIDL	NNP
Aikau	Aikau	NNP
AIML	AIML	NNP
aiohttp	aiohttp	NNP
Airbrake	Airbrake	NNP
AirConsole	AirConsole	NNP
Aircrack	Aircrack	NNP
AirPrint	AirPrint	NNP
AirPush	AirPush	NNP
Airtable	Airtable	NNP
AirWatch	AirWatch	NNP
AjaxForm	AjaxForm	NNP
AjaxMin	AjaxMin	NNP
AjaxQ	AjaxQ	NNP
AJDT	AJDT	NNP
Akavache	Akavache	NNP
Akeneo	Akeneo	NNP
Alamofire	Alamofire	NNP
AlaSQL	AlaSQL	NNP
AlchemyAPI	AlchemyAPI	NNP
alertdialogs	alertdialog	NNS
alertdialog	alertdialog	NN
alertify	alertify	NNP
alertifyjs	alertifyjs	NNP
alertviews	alertview	NNS
alertview	alertview	NN
Alfa	Alfa	NNP
Algolia	Algolia	NNP
Alibaba	Alibaba	NNP
AlivePDF	AlivePDF	NNP
allauth	allauth	NN
AllJoyn	AllJoyn	NNP
Alluxio	Alluxio	NNP
alpacajs	alpacajs	NNP
Alpakka	Alpakka	NNP
ALSA	ALSA	NNP
AltBeacon	AltBeacon	NNP
Alteryx	Alteryx	NNP
AltiVec	AltiVec	NN
AltoRouter	AltoRouter	NNP
Altova	Altova	NNP
AMBA	AMBA	NNP
Ambari	Ambari	NNP
amcharts	amcharts	NNP
Amdahl	Amdahl	NNP
Amfphp	Amfphp	NNP
AmiBroker	AmiBroker	NNP
AmMap	AmMap	NNP
ammonites	ammonite	NNS
ammonite	ammonite	NN
AMPL	AMPL	NNP
AmplifyJS	AmplifyJS	NNP
AMPPS	AMPPS	NNP
AMPscript	AMPscript	NNP
AMQP	AMQP	NNP
Amstock	Amstock	NNP
Anchorpoint	Anchorpoint	NNP
ANCS	ANCS	NNP
AndEngine	AndEngine	NNP
AndroidAsync	AndroidAsync	NNP
AndroidQ	AndroidQ	NNP
AndroidX	AndroidX	NNP
AngleSharp	AngleSharp	NNP
AngularFire	AngularFire	NNP
angulartics	angulartics	NNP
Anjuta	Anjuta	NNP
AnkhSVN	AnkhSVN	NNP
Anki	Anki	NNP
Anko	Anko	NNP
annyang	annyang	NNP
Anorm	Anorm	NNP
ANOVA	ANOVA	NN
ANPR	ANPR	NN
antialiasing	antialiasing	NN
AntiSamy	AntiSamy	NNP
ANTLR	ANTLR	NNP
ANTLRWorks	ANTLRWorks	NNP
AntRun	AntRun	NNP
AnyChart	AnyChart	NNP
AnyCPU	AnyCPU	NN
AnyDAC	AnyDAC	NNP
AnyEvent	AnyEvent	NNP
AnyLogic	AnyLogic	NNP
Anypoint	Anypoint	NNP
ApacheBench	ApacheBench	NNP
ApacheDS	ApacheDS	NNP
APCu	APCu	NNP
APDU	APDU	NNP
ApexCharts	ApexCharts	NNP
APIC	APIC	NNP
Apify	Apify	NNP
Apigee	Apigee	NNP
Apigility	Apigility	NNP
apksigner	apksigner	NNP
apktool	apktool	NN
APNG	APNG	NNP
APNs	APNs	NNP
APOC	APOC	NNP
AppArmor	AppArmor	NNP
AppAuth	AppAuth	NNP
appbars	appbar	NNS
appbar	appbar	NN
AppCache	AppCache	NN
appcache	appcache	NN
Appcelerator	Appcelerator	NNP
AppCmd	AppCmd	NNP
AppCode	AppCode	NNP
AppCompat	AppCompat	NNP
AppData	AppData	NNP
AppDynamics	AppDynamics	NNP
Appery	Appery	NNP
AppFabric	AppFabric	NNP
AppFog	AppFog	NNP
AppFuse	AppFuse	NNP
AppGyver	AppGyver	NNP
AppHarbor	AppHarbor	NNP
Appium	Appium	NNP
AppJS	AppJS	NNP
AppKit	AppKit	NNP
appledoc	appledoc	NNP
AppLovin	AppLovin	NNP
Applozic	Applozic	NNP
Appmobi	Appmobi	NNP
Appodeal	Appodeal	NNP
Apportable	Apportable	NNP
AppRTC	AppRTC	NNP
appserver	appserver	NN
AppsFlyer	AppsFlyer	NNP
AppSource	AppSource	NNP
Appstats	Appstats	NNP
AppSync	AppSync	NNP
AppVeyor	AppVeyor	NNP
AppWarp	AppWarp	NNP
appx	appx	NN
AppxManifest	AppxManifest	NNP
apriori	apriori	FW
Aptana	Aptana	NNP
Aquamacs	Aquamacs	NNP
ArangoDB	ArangoDB	NNP
ArangoJS	ArangoJS	NNP
Arcanist	Arcanist	NNP
ArcGIS	ArcGIS	NNP
Archilogic	Archilogic	NNP
Archiva	Archiva	NNP
archivers	archiver	NNS
archiver	archiver	NN
ArcMap	ArcMap	NNP
ArcObjects	ArcObjects	NNP
ARCore	ARCore	NNP
ArcPy	ArcPy	NNP
ARFF	ARFF	NNP
ARGB	ARGB	NNP
argmax	argmax	NNP
ArgoUML	ArgoUML	NNP
argparse	argparse	NNP
ARIMA	ARIMA	NNP
arithmetics	arithmetics	NN
armcc	armcc	NNP
ARPACK	ARPACK	NNP
arraybuffers	arraybuffer	NNS
arraybuffer	arraybuffer	NN
arraycopy	arraycopy	NN
arraydeques	arraydeque	NNS
arraydeque	arraydeque	NN
ArrayFire	ArrayFire	NNP
arraylists	arraylist	NNS
arraylist	arraylist	NN
arrayobjects	arrayobject	NNS
arrayobject	arrayobject	NN
Artifactory	Artifactory	NNP
ARToolKit	ARToolKit	NNP
ArUco	ArUco	NNP
arules	arules	NNP
asadmin	asadmin	NNP
asar	asar	NNP
asax	asax	NNP
AsciiDoc	AsciiDoc	NNP
Asciidoctor	Asciidoctor	NNP
ascx	ascx	NNP
asdoc	asdoc	NNP
ashx	ashx	NNP
ASIC	ASIC	NNP
ASIO	ASIO	NNP
ASLR	ASLR	NNP
asmack	asmack	NNP
ASMX	ASMX	NNP
ASPNETDB	ASPNETDB	NNP
Aspose	Aspose	NNP
ASPX	ASPX	NNP
ASPXAUTH	ASPXAUTH	NNP
Assembla	Assembla	NNP
AssertJ	AssertJ	NNP
Assetic	Assetic	NNP
Assi	Assi	NNP
Assimp	Assimp	NNP
Astropy	Astropy	NNP
Astyanax	Astyanax	NNP
AStyle	AStyle	NNP
asyncio	asyncio	NNP
asyncore	asyncore	NNP
asyncpg	asyncpg	NNP
AsyncStorage	AsyncStorage	NNP
ATDD	ATDD	NNP
Atmega	Atmega	NNP
Atmel	Atmel	NNP
AtomPub	AtomPub	NNP
AtTask	AtTask	NNP
Attiny	Attiny	NNP
attoparsec	attoparsec	NNP
Attunity	Attunity	NNP
aubio	aubio	NNP
AUCTeX	AUCTeX	NNP
AudioEffect	AudioEffect	NNP
AudioKit	AudioKit	NNP
Augeas	Augeas	NNP
Authenticode	Authenticode	NNP
Authlogic	Authlogic	NNP
AuthSub	AuthSub	NNP
Authy	Authy	NNP
AuthZ	AuthZ	NNP
AuthzForce	AuthzForce	NNP
AutoBean	AutoBean	NNP
AutoCAD	AutoCAD	NNP
autocloseable	autocloseable	JJ
autocmd	autocmd	NNP
autoconf	autoconf	NNP
autocorrect	autocorrect	NN
autocrlf	autocrlf	NNP
autodiff	autodiff	NNP
Autodiscovery	Autodiscovery	NNP
AutoDoc	AutoDoc	NNP
Autofac	Autofac	NNP
AutoForm	AutoForm	NNP
autoformatting	autoformatting	NN
AutoGen	AutoGen	NNP
autogen	autogen	NN
autograd	autograd	NNP
Autogrow	Autogrow	NNP
AutoHotkey	AutoHotkey	NNP
AutoIt	AutoIt	NNP
AutoKey	AutoKey	NNP
Autolink	Autolink	NNP
AutoLISP	AutoLISP	NNP
autoload	autoload	NN
autologin	autologin	NN
Automake	Automake	NNP
AutoMapper	AutoMapper	NNP
automapping	automapping	NN
Automatonymous	Automatonymous	NNP
Automator	Automator	NNP
AutoML	AutoML	NNP
automocking	automocking	NN
AutoMoq	AutoMoq	NNP
automount	automount	NN
autonumber	autonumber	NNP
autoreconf	autoreconf	NNP
autoregressive	autoregressive	JJ
autoresize	autoresize	NN
AutoRest	AutoRest	NNP
autorun	autorun	NNP
AUTOSAR	AUTOSAR	NNP
autoscaling	autoscaling	NN
autoscroll	autoscroll	NN
autostart	autostart	NN
AutoSys	AutoSys	NNP
autotests	autotest	NNS
autotest	autotest	NN
Autotools	Autotools	NNP
autovacuum	autovacuum	NNP
Autowired	Autowired	NNP
Avahi	Avahi	NNP
AvalonDock	AvalonDock	NNP
AvaloniaUI	AvaloniaUI	NNP
AVAsset	AVAsset	NNP
AVCam	AVCam	NNP
AVFoundation	AVFoundation	NNP
Aviarc	Aviarc	NNP
AviSynth	AviSynth	NNP
AVPlayer	AVPlayer	NNP
AVRCP	AVRCP	NNP
AVRDude	AVRDude	NNP
Avro	Avro	NNP
AWeber	AWeber	NNP
Awesomium	Awesomium	NNP
AWStats	AWStats	NNP
awtrobot	awtrobot	NNP
Axapta	Axapta	NNP
axlsx	axlsx	NNP
AzCopy	AzCopy	NNP
AzerothCore	AzerothCore	NNP
AzMan	AzMan	NNP
BaasBox	BaasBox	NNP
babelify	babelify	NNP
babeljs	babeljs	NNP
Babun	Babun	NNP
BabylonJS	BabylonJS	NNP
Backand	Backand	NNP
backcolor	backcolor	NN
Backendless	Backendless	NNP
Backgrid	Backgrid	NNP
backgrounding	backgrounding	JJ
backlight	backlight	NN
backoff	backoff	NN
BackOffice	BackOffice	NNP
backplane	backplane	NN
backpressure	backpressure	NN
backpropagation	backpropagation	NN
backstack	backstack	NN
BACnet	BACnet	NNP
BACPAC	BACPAC	NNP
Bacula	Bacula	NNP
bada	bada	NNP
Baidu	Baidu	NNP
balancer	balancer	NN
BAML	BAML	NNP
BAPI	BAPI	NNP
Baqend	Baqend	NNP
Basemap	Basemap	NNP
BaseX	BaseX	NNP
BASM	BASM	NNP
Batarang	Batarang	NNP
Bazel	Bazel	NNP
BBCode	BBCode	NNP
BBEdit	BBEdit	NNP
bbPress	bbPress	NNP
bcdedit	bcdedit	NNP
BCEL	BCEL	NNP
BCMath	BCMath	NNP
BCNF	BCNF	NNP
bcrypt	bcrypt	NNP
BeagleBoard	BeagleBoard	NNP
Beamer	Beamer	NNP
BeanShell	BeanShell	NNP
Beanstalkd	Beanstalkd	NNP
BeanUtils	BeanUtils	NNP
Beego	Beego	NNP
Behat	Behat	NNP
Berkshelf	Berkshelf	NNP
Betfair	Betfair	NNP
BibLaTeX	BibLaTeX	NNP
BibTeX	BibTeX	NNP
bicubic	bicubic	JJ
BigchainDB	BigchainDB	NNP
BigCommerce	BigCommerce	NNP
BigInsights	BigInsights	NNP
bigintegers	biginteger	NNS
biginteger	biginteger	NN
bigmemory	bigmemory	NNP
BigQuery	BigQuery	NNP
BigSQL	BigSQL	NNP
BigTable	BigTable	NNP
biicode	biicode	NNP
bijection	bijection	NN
BiMap	BiMap	NNP
Biml	Biml	NNP
Binance	Binance	NNP
Bintray	Bintray	NNP
Binutils	Binutils	NNP
Bioconductor	Bioconductor	NNP
BioMart	BioMart	NNP
Bioperl	Bioperl	NNP
Biopython	Biopython	NNP
BIRT	BIRT	NNP
bitarrays	bitarray	NNS
bitarray	bitarray	NN
BitBake	BitBake	NNP
bitboards	bitboard	NNS
bitboard	bitboard	NN
Bitcode	Bitcode	NNP
bitcoind	bitcoind	NNP
bitcoinj	bitcoinj	NNP
Bitcore	Bitcore	NNP
bitflags	bitflag	NNS
bitflag	bitflag	NN
BitLocker	BitLocker	NNP
bitmasks	bitmask	NNS
bitmask	bitmask	NN
Bitnami	Bitnami	NNP
Bitrise	Bitrise	NNP
Bitrix	Bitrix	NNP
Bitronix	Bitronix	NNP
bitsets	bitset	NNS
bitset	bitset	NN
bitstreams	bitstream	NNS
bitstream	bitstream	NN
BitTorrent	BitTorrent	NNP
bitvectors	bitvector	NNS
bitvector	bitvector	NN
Bixby	Bixby	NNP
BizSpark	BizSpark	NNP
BizTalk	BizTalk	NNP
BJam	BJam	NNP
BjyAuthorize	BjyAuthorize	NNP
BLAS	BLAS	NNP
BlazeDS	BlazeDS	NNP
Blazegraph	Blazegraph	NNP
BlazeMeter	BlazeMeter	NNP
Blazor	Blazor	NNP
Blobstore	Blobstore	NNP
blockingqueues	blockingqueue	NNS
blockingqueue	blockingqueue	NN
Blockly	Blockly	NNP
blogdown	blogdown	NNP
BlogEngine	BlogEngine	NNP
Blogspot	Blogspot	NNP
Bloomberg	Bloomberg	NNP
Blowfish	Blowfish	NNP
BLPAPI	BLPAPI	NNP
BlueCove	BlueCove	NNP
BlueDragon	BlueDragon	NNP
Bluegiga	Bluegiga	NNP
Bluehost	Bluehost	NNP
blueimp	blueimp	NNP
BlueJ	BlueJ	NNP
Bluemix	Bluemix	NNP
blueprintjs	blueprintjs	NNP
BlueSnap	BlueSnap	NNP
BlueStacks	BlueStacks	NNP
BlueZ	BlueZ	NNP
Bndtools	Bndtools	NNP
bnlearn	bnlearn	NNP
Bochs	Bochs	NNP
Bodymovin	Bodymovin	NNP
Boehm	Boehm	NNP
Boids	Boids	NNP
boilerpipe	boilerpipe	NNP
BoilerplateJS	BoilerplateJS	NNP
Bokeh	Bokeh	NNP
BokehJS	BokehJS	NNP
BoltDB	BoltDB	NNP
BoofCV	BoofCV	NNP
bookdown	bookdown	NNP
bookmarklet	bookmarklet	NNP
BookSleeve	BookSleeve	NNP
Boomi	Boomi	NNP
Bootbox	Bootbox	NNP
bootclasspath	bootclasspath	NN
Bootgrid	Bootgrid	NNP
bootloaders	bootloader	NNS
bootloader	bootloader	NN
BootsFaces	BootsFaces	NNP
Bootswatch	Bootswatch	NNP
borderless	borderless	JJ
borderpanes	borderpane	NNS
borderpane	borderpane	NN
BoringSSL	BoringSSL	NNP
Borland	Borland	NNP
BOTAN	BOTAN	NNP
Botkit	Botkit	NNP
boto	boto	NNP
botocore	botocore	NNP
Bottlenose	Bottlenose	NNP
Boxfuse	Boxfuse	NNP
boxlayouts	boxlayout	NNS
boxlayout	boxlayout	NN
boxplot	boxplot	NNP
BPEL	BPEL	NNP
BPMN	BPMN	NNP
Braintree	Braintree	NNP
Breakpad	Breakpad	NNP
BreezingForms	BreezingForms	NNP
Bresenham	Bresenham	NNP
Brightcove	Brightcove	NNP
BrightScript	BrightScript	NNP
Brightway	Brightway	NNP
BRMS	BRMS	NNP
Broadcom	Broadcom	NNP
Broadleaf	Broadleaf	NNP
broccolijs	broccolijs	NNP
Brotli	Brotli	NNP
browsable	browsable	JJ
Browscap	Browscap	NNP
Browserify	Browserify	NNP
Brython	Brython	NNP
BSoD	BSoD	NNP
BSSID	BSSID	NNP
BTDF	BTDF	NNP
BTLE	BTLE	NNP
BTrace	BTrace	NNP
Btrfs	Btrfs	NNP
Btrieve	Btrieve	NNP
BuckleScript	BuckleScript	NNP
Buckminster	Buckminster	NNP
BuddyPress	BuddyPress	NNP
Buefy	Buefy	NNP
Bugsense	Bugsense	NNP
Bugsnag	Bugsnag	NNP
Buildbot	Buildbot	NNP
BuildConfig	BuildConfig	NNP
BuildFire	BuildFire	NNP
buildnumber	buildnumber	NN
Buildout	Buildout	NNP
buildozer	buildozer	NNP
buildpath	buildpath	NN
Buildr	Buildr	NNP
Buildroot	Buildroot	NNP
Buildship	Buildship	NNP
Bukkit	Bukkit	NNP
BulkLoader	BulkLoader	NNP
BulkSMS	BulkSMS	NNP
Bulma	Bulma	NNP
Bundler	Bundler	NNP
BusyBox	BusyBox	NNP
Butterworth	Butterworth	NNP
buttonbars	buttonbar	NNS
buttonbar	buttonbar	NN
buttongroups	buttongroup	NNS
buttongroup	buttongroup	NN
byebug	byebug	NNP
Byobu	Byobu	NNP
bytea	bytea	NN
bytearrays	bytearray	NNS
bytearray	bytearray	NN
bytebuffers	bytebuffer	NNS
bytebuffer	bytebuffer	NN
BytesIO	BytesIO	NNP
CACLS	CACLS	NNP
cAdvisor	cAdvisor	NNP
Caffe	Caffe	NNP
Cairngorm	Cairngorm	NNP
Caja	Caja	NNP
CakeDC	CakeDC	NNP
CakePHP	CakePHP	NNP
CALayer	CALayer	NNP
CalDAV	CalDAV	NNP
Caldroid	Caldroid	NNP
Caliburn	Caliburn	NNP
callcc	callcc	NNP
CallKit	CallKit	NNP
callstacks	callstack	NNS
callstack	callstack	NN
CamanJS	CamanJS	NNP
camelcasing	camelcasing	JJ
CameraX	CameraX	NNP
Caml	Caml	NNP
Camunda	Camunda	NNP
CanActivate	CanActivate	NNP
CanCanCan	CanCanCan	NNP
CanJS	CanJS	NNP
canonicalization	canonicalization	NN
CanvasJS	CanvasJS	NNP
CanVG	CanVG	NNP
CAPICOM	CAPICOM	NNP
Capifony	Capifony	NNP
CAPL	CAPL	NNP
CapnProto	CapnProto	NNP
capslock	capslock	NN
Capybara	Capybara	NNP
CardDAV	CardDAV	NNP
carouFredSel	carouFredSel	NNP
CarPlay	CarPlay	NNP
Carrierwave	Carrierwave	NNP
Cartalyst	Cartalyst	NNP
CartoDB	CartoDB	NNP
cartopy	cartopy	NNP
Casbah	Casbah	NNP
CasperJS	CasperJS	NNP
CASPOL	CASPOL	NNP
Cassini	Cassini	NNP
CatBoost	CatBoost	NNP
Catel	Catel	NNP
CATIA	CATIA	NNP
CATiledLayer	CATiledLayer	NNP
Catmull	Catmull	NNP
CBIR	CBIR	NNP
CBLAS	CBLAS	NNP
CBOR	CBOR	NNP
CCAvenue	CCAvenue	NNP
CCNET	CCNET	NNP
CDMA	CDMA	NNP
CEDET	CEDET	NNP
CefGlue	CefGlue	NNP
CefSharp	CefSharp	NNP
celeryd	celeryd	NNP
Centura	Centura	NNP
Ceph	Ceph	NNP
Certbot	Certbot	NNP
CertEnroll	CertEnroll	NNP
certutil	certutil	NNP
CEWP	CEWP	NNP
cfchart	cfchart	NNP
CFEngine	CFEngine	NNP
CFFI	CFFI	NNP
CFML	CFML	NNP
CFNetwork	CFNetwork	NNP
CFWheels	CFWheels	NNP
CGAL	CGAL	NNP
Chaco	Chaco	NNP
Chaincode	Chaincode	NNP
Chainer	Chainer	NNP
ChaiScript	ChaiScript	NNP
chaplinjs	chaplinjs	NNP
Chaquopy	Chaquopy	NNP
Chardet	Chardet	NNP
Chargify	Chargify	NNP
Chartboost	Chartboost	NNP
Chartist	Chartist	NNP
Chartkick	Chartkick	NNP
Chatbase	Chatbase	NNP
Chatfuel	Chatfuel	NNP
ChatterBot	ChatterBot	NNP
CheckIns	CheckIns	NNP
checkmarks	checkmark	NNS
checkmark	checkmark	NN
Checkmarx	Checkmarx	NNP
checkpointing	checkpointing	NN
ChefDK	ChefDK	NNP
ChefSpec	ChefSpec	NNP
CherryPy	CherryPy	NNP
Chez	Chez	NNP
ChicagoBoss	ChicagoBoss	NNP
Chilkat	Chilkat	NNP
choco	choco	NNP
Chocolatey	Chocolatey	NNP
choicefields	choicefield	NNS
choicefield	choicefield	NN
Chokidar	Chokidar	NNP
choropleth	choropleth	JJ
choroplethr	choroplethr	NNP
chromakeys	chromakey	NNS
chromakey	chromakey	NN
Chromebook	Chromebook	NNP
Chromeless	Chromeless	NNP
Chron	Chron	NNP
ChronoForms	ChronoForms	NNP
Chronograf	Chronograf	NNP
Chronos	Chronos	NNP
chroot	chroot	NNP
chruby	chruby	NNP
CHtml	CHtml	NNP
CICS	CICS	NNP
Cilk	Cilk	NNP
CImg	CImg	NNP
circlize	circlize	NNP
Circos	Circos	NNP
Citus	Citus	NNP
CiviCRM	CiviCRM	NNP
cJSON	cJSON	NNP
CKAN	CKAN	NNP
CKFinder	CKFinder	NNP
Clarifai	Clarifai	NNP
ClaudiaJS	ClaudiaJS	NNP
CLDC	CLDC	NNP
CLDR	CLDR	NNP
ClearCase	ClearCase	NNP
ClearDB	ClearDB	NNP
ClearType	ClearType	NNP
CleverTap	CleverTap	NNP
ClickHouse	ClickHouse	NNP
ClickOnce	ClickOnce	NNP
clingo	clingo	NN
CLISP	CLISP	NNP
cloc	cloc	NNP
Clockify	Clockify	NNP
ClockKit	ClockKit	NNP
ClojureCLR	ClojureCLR	NNP
ClojureScript	ClojureScript	NNP
Cloo	Cloo	NNP
CLOS	CLOS	NNP
ClosedXML	ClosedXML	NNP
CloudAMQP	CloudAMQP	NNP
Cloudant	Cloudant	NNP
CloudBees	CloudBees	NNP
CloudBerry	CloudBerry	NNP
CloudBoost	CloudBoost	NNP
Cloudera	Cloudera	NNP
CloudFiles	CloudFiles	NNP
CloudFormation	CloudFormation	NNP
CloudHub	CloudHub	NNP
Cloudify	Cloudify	NNP
Cloudinary	Cloudinary	NNP
CloudKit	CloudKit	NNP
CloudMade	CloudMade	NNP
CloudPebble	CloudPebble	NNP
CloudRail	CloudRail	NNP
CloudSearch	CloudSearch	NNP
CloudSight	CloudSight	NNP
CloudSim	CloudSim	NNP
CloudStack	CloudStack	NNP
CloudTrail	CloudTrail	NNP
CloudWatch	CloudWatch	NNP
Cloudways	Cloudways	NNP
clpfd	clpfd	NNP
ClrMD	ClrMD	NNP
CLRS	CLRS	NNP
CLSID	CLSID	NNP
clueTip	clueTip	NNP
CMDB	CMDB	NNP
cmder	cmder	NNP
cmdlets	cmdlet	NNS
cmdlet	cmdlet	NN
CmdShell	CmdShell	NNP
CMIS	CMIS	NNP
CMMI	CMMI	NNP
cmocka	cmocka	NNP
CModel	CModel	NNP
CMSIS	CMSIS	NNP
CMUSphinx	CMUSphinx	NNP
CNTK	CNTK	NNP
CoAP	CoAP	NNP
Cobertura	Cobertura	NNP
CockroachDB	CockroachDB	NNP
CocoaLumberjack	CocoaLumberjack	NNP
CocoaPods	CocoaPods	NNP
CocoonJS	CocoonJS	NNP
CocosSharp	CocosSharp	NNP
Codacy	Codacy	NNP
Codeanywhere	Codeanywhere	NNP
Codeblocks	Codeblocks	NNP
CodeBuild	CodeBuild	NNP
Codeception	Codeception	NNP
CodeceptJS	CodeceptJS	NNP
CodeDOM	CodeDOM	NNP
CodeFluent	CodeFluent	NNP
CodeIgniter	CodeIgniter	NNP
CodeKit	CodeKit	NNP
CodeLens	CodeLens	NNP
CodeLite	CodeLite	NNP
CodeModel	CodeModel	NNP
CodeNarc	CodeNarc	NNP
Codenvy	Codenvy	NNP
codepages	codepage	NNS
codepage	codepage	NN
CodePen	CodePen	NNP
CodePipeline	CodePipeline	NNP
CodePlex	CodePlex	NNP
CodeRay	CodeRay	NNP
CodeRunner	CodeRunner	NNP
CodeRush	CodeRush	NNP
CodeSandbox	CodeSandbox	NNP
Codeship	Codeship	NNP
CodeSkulptor	CodeSkulptor	NNP
Codesmith	Codesmith	NNP
CodeSniffer	CodeSniffer	NNP
Codesourcery	Codesourcery	NNP
CodeStar	CodeStar	NNP
CodeSynthesis	CodeSynthesis	NNP
CODESYS	CODESYS	NNP
CodeWarrior	CodeWarrior	NNP
Codio	Codio	NNP
COFF	COFF	NNP
CoffeeScript	CoffeeScript	NNP
Cognito	Cognito	NNP
Cognos	Cognos	NNP
Coinbase	Coinbase	NNP
Colaboratory	Colaboratory	NNP
ColdBox	ColdBox	NNP
ColdFusion	ColdFusion	NNP
CollabNet	CollabNet	NNP
COLLADA	COLLADA	NNP
collapsable	collapsable	JJ
collectd	collectd	NNP
Colorama	Colorama	NNP
Colorbox	Colorbox	NNP
ColorBrewer	ColorBrewer	NNP
ColorMatrix	ColorMatrix	NNP
combinators	combinator	NNS
combinatorics	combinatorics	NN
Combres	Combres	NNP
CometChat	CometChat	NNP
CometD	CometD	NNP
commandbars	commandbar	NNS
commandbar	commandbar	NN
commandlink	commandlink	NNP
commentable	commentable	JJ
commercetools	commercetools	NNP
CommonJ	CommonJ	NNP
CommonsWare	CommonsWare	NNP
Communicat	Communicat	NNP
Compiz	Compiz	NNP
Compojure	Compojure	NNP
ComponentArt	ComponentArt	NNP
CompoundJS	CompoundJS	NNP
comtypes	comtypes	NNP
concatmap	concatmap	NNP
Concordion	Concordion	NNP
ConEmu	ConEmu	NNP
ConfigMaps	ConfigMap	NNPS
ConfigMap	ConfigMap	NNP
ConfigParser	ConfigParser	NNP
confirmable	confirmable	JJ
Conky	Conky	NNP
Connman	Connman	NNP
contactless	contactless	JJ
ContactUS	ContactUS	NNP
Contao	Contao	NNP
Contentful	Contentful	NNP
contentpanes	contentpane	NNS
contentpane	contentpane	NN
Contiki	Contiki	NNP
contourf	contourf	NNP
contravariance	contravariance	NN
ControlsFX	ControlsFX	NNP
conv	conv	NNP
ConvertAPI	ConvertAPI	NNP
convolutional	convolutional	JJ
Conways	Conways	NNP
Cooja	Cooja	NNP
Cookiecutter	Cookiecutter	NNP
CookieJar	CookieJar	NNP
cookieless	cookieless	JJ
CoolStorage	CoolStorage	NNP
CoovaChilli	CoovaChilli	NNP
CoqIDE	CoqIDE	NNP
Corasick	Corasick	NNP
CORBA	CORBA	NNP
Corda	Corda	NNP
Cordova	Cordova	NNP
CoreCLR	CoreCLR	NNP
CoreDNS	CoreDNS	NNP
CorelDRAW	CorelDRAW	NNP
CoreMIDI	CoreMIDI	NNP
coremltools	coremltools	NNP
CoreOS	CoreOS	NNP
coreutils	coreutils	NNP
CorFlags	CorFlags	NNP
Corosync	Corosync	NNP
coroutines	coroutine	NNS
coroutine	coroutine	NN
corrplot	corrplot	NNP
Cortana	Cortana	NNP
CosmicMind	CosmicMind	NNP
Costura	Costura	NNP
COSU	COSU	NNP
coturn	coturn	NNP
CouchApp	CouchApp	NNP
CouchDB	CouchDB	NNP
CouchRest	CouchRest	NNP
Coverflow	Coverflow	NNP
Coverity	Coverity	NNP
cowplot	cowplot	NNP
CPack	CPack	NNP
CPAN	CPAN	NNP
CPANm	CPANm	NNP
CPLEX	CPLEX	NNP
Cppcheck	Cppcheck	NNP
CppCMS	CppCMS	NNP
cpplint	cpplint	NNP
cpprest	cpprest	NNP
CppUnit	CppUnit	NNP
CppUTest	CppUTest	NNP
cProfile	cProfile	NNP
CPUID	CPUID	NNP
CPython	CPython	NNP
cqlengine	cqlengine	NNP
CQLinq	CQLinq	NNP
cqlsh	cqlsh	NNP
CQRS	CQRS	NNP
CQWP	CQWP	NNP
Crafter	Crafter	NNP
CraftyJS	CraftyJS	NNP
Craigslist	Craigslist	NNP
CRAN	CRAN	NNP
Crashlytics	Crashlytics	NNP
CrateDB	CrateDB	NNP
CreateJS	CreateJS	NNP
CRF++	CRF++	NNP
Crittercism	Crittercism	NNP
crontab	crontab	NNP
CronTrigger	CronTrigger	NNP
Croogo	Croogo	NNP
Croppie	Croppie	NNP
crossdomain	crossdomain	NNP
Crossfilter	Crossfilter	NNP
Crossrider	Crossrider	NNP
crosstool	crosstool	NNP
CRTP	CRTP	NNP
CruiseControl	CruiseControl	NNP
CryEngine	CryEngine	NNP
Crypto++	Crypto++	NNP
CryptoAPI	CryptoAPI	NNP
CryptoJS	CryptoJS	NNP
cscope	cscope	NNP
CSCore	CSCore	NNP
csharp	csharp	NNP
CSIP	CSIP	NNP
CSLA	CSLA	NNP
CSOM	CSOM	NNP
Csound	Csound	NNP
csplit	csplit	NNP
csproj	csproj	NNP
CSSLint	CSSLint	NNP
CssMin	CssMin	NNP
cssnext	cssnext	NNP
CSSOM	CSSOM	NNP
CSVkit	CSVkit	NNP
cTAKES	cTAKES	NNP
CTest	CTest	NNP
CTools	CTools	NNP
CtrlP	CtrlP	NNP
cuBLAS	cuBLAS	NNP
CUCM	CUCM	NNP
CUDA	CUDA	NNP
CUDAfy	CUDAfy	NNP
CUDD	CUDD	NNP
cuDNN	cuDNN	NNP
cuFFT	cuFFT	NNP
Cufon	Cufon	NNP
Cumulocity	Cumulocity	NNP
CUnit	CUnit	NNP
Cupertino	Cupertino	NNP
CuPy	CuPy	NNP
cURLpp	cURLpp	NNP
cuSolver	cuSolver	NNP
CVSNT	CVSNT	NNP
CVST	CVST	NNP
CVXOPT	CVXOPT	NNP
CVXPY	CVXPY	NNP
CWAC	CWAC	NNP
CXFRS	CXFRS	NNP
cXML	cXML	NNP
CyanogenMod	CyanogenMod	NNP
Cyberduck	Cyberduck	NNP
CyberSource	CyberSource	NNP
Cydia	Cydia	NNP
Cython	Cython	NNP
cythonize	cythonize	NNP
Cytoscape	Cytoscape	NNP
CZML	CZML	NNP
DAAB	DAAB	NNP
DACL	DACL	NNP
DACPAC	DACPAC	NNP
Dafny	Dafny	NNP
Dagre	Dagre	NNP
Dailymotion	Dailymotion	NNP
Dajax	Dajax	NNP
dajaxice	dajaxice	NNP
DalekJS	DalekJS	NNP
Dalvik	Dalvik	NNP
DAML	DAML	NNP
Darcs	Darcs	NNP
Darkflow	Darkflow	NNP
DarkNet	DarkNet	NNP
Dartium	Dartium	NNP
Dashcode	Dashcode	NNP
dashDB	dashDB	NNP
Dask	Dask	NNP
DataBind	DataBind	NNP
Databricks	Databricks	NNP
Datadog	Datadog	NNP
DataDude	DataDude	NNP
Datafeed	Datafeed	NNP
Dataflow	Dataflow	NNP
DataFrame	DataFrame	NNP
DataGrip	DataGrip	NNP
datajs	datajs	NNP
Datalab	Datalab	NNP
DataLayer	DataLayer	NNP
Datalog	Datalog	NNP
DataMaps	DataMaps	NNP
DataMatrix	DataMatrix	NNP
DataModule	DataModule	NNP
DataNitro	DataNitro	NNP
DataNode	DataNode	NNP
DataNucleus	DataNucleus	NNP
Datapoint	Datapoint	NNP
DataPower	DataPower	NNP
Dataprep	Dataprep	NNP
Dataproc	Dataproc	NNP
Datashader	Datashader	NNP
datasheets	datasheet	NNS
datasheet	datasheet	NN
DataSnap	DataSnap	NNP
Datasource	Datasource	NNP
DataStage	DataStage	NNP
DataStax	DataStax	NNP
DataStep	DataStep	NNP
Datastore	Datastore	NNP
datastructures	datastructure	NNS
DataVirt	DataVirt	NNP
DataViz	DataViz	NNP
DataWeave	DataWeave	NNP
Datazen	Datazen	NNP
dateboxes	datebox	NNS
datebox	datebox	NN
datechoosers	datechooser	NNS
datechooser	datechooser	NN
datestamps	datestamp	NNS
datestamp	datestamp	NN
Datomic	Datomic	NNP
DayPilot	DayPilot	NNP
dbaccess	dbaccess	NNP
DBAL	DBAL	NNP
dBase	dBase	NNP
DBCC	DBCC	NNP
DBeaver	DBeaver	NNP
dbExpress	dbExpress	NNP
DbFit	DbFit	NNP
DBFlow	DBFlow	NNP
dbForge	dbForge	NNP
dbghelp	dbghelp	NNP
DBGrid	DBGrid	NNP
DBIX	DBIX	NNP
dblink	dblink	NNP
DBLinq	DBLinq	NNP
DBMail	DBMail	NNP
DBML	DBML	NNP
DBpedia	DBpedia	NNP
dbplyr	dbplyr	NNP
dbproj	dbproj	NNP
DBSCAN	DBSCAN	NNP
DBUnit	DBUnit	NNP
DBus	DBus	NNP
DbUtils	DbUtils	NNP
DbVisualizer	DbVisualizer	NNP
DCEVM	DCEVM	NNP
DCGAN	DCGAN	NNP
DCMTK	DCMTK	NNP
DCOM	DCOM	NNP
DDEV	DDEV	NNP
DDMS	DDMS	NNP
DDoS	DDoS	NNP
DEAP	DEAP	NNP
debconf	debconf	NNP
Debezium	Debezium	NNP
debhelper	debhelper	NNP
Debian	Debian	NNP
debouncing	debouncing	NN
DebugView	DebugView	NNP
Deedle	Deedle	NNP
DeepLab	DeepLab	NNP
deeplink	deeplink	NNP
DeepStream	DeepStream	NNP
defragmentation	defragmentation	NN
Deis	Deis	NNP
Delaunay	Delaunay	NNP
DeltaSpike	DeltaSpike	NNP
Demandware	Demandware	NNP
dendextend	dendextend	NNP
dendrogram	dendrogram	NN
Denodo	Denodo	NNP
deobfuscation	deobfuscation	NN
Deployd	Deployd	NNP
Deployer	Deployer	NNP
DerbyJS	DerbyJS	NNP
DescTools	DescTools	NNP
Detekt	Detekt	NNP
Devart	Devart	NNP
DevCon	DevCon	NNP
Devenv	Devenv	NNP
DevExpress	DevExpress	NNP
DevExtreme	DevExtreme	NNP
DevForce	DevForce	NNP
devkitPro	devkitPro	NNP
DevOps	DevOps	NNP
DevPi	DevPi	NNP
DevStack	DevStack	NNP
DevTest	DevTest	NNP
DexGuard	DexGuard	NNP
Dexie	Dexie	NNP
DFSORT	DFSORT	NNP
DGML	DGML	NNP
Dgraph	Dgraph	NNP
DHIS	DHIS	NNP
DHTML	DHTML	NNP
DHTMLX	DHTMLX	NNP
Diagrammer	Diagrammer	NNP
Dialogflow	Dialogflow	NNP
dialplan	dialplan	NN
Dialyzer	Dialyzer	NNP
Diazo	Diazo	NNP
DiCom	DiCom	NNP
DiffMerge	DiffMerge	NNP
difftool	difftool	NNP
Diffutils	Diffutils	NNP
digester	digester	NN
Digg	Digg	NNP
Dijit	Dijit	NNP
DirectAdmin	DirectAdmin	NNP
DirectCast	DirectCast	NNP
DirectDraw	DirectDraw	NNP
DirectFB	DirectFB	NNP
Directus	Directus	NNP
DirectX	DirectX	NNP
DirectXMath	DirectXMath	NNP
DirectXTK	DirectXTK	NNP
Dired	Dired	NNP
Discogs	Discogs	NNP
DiskCache	DiskCache	NNP
DiskImage	DiskImage	NNP
DiskUsage	DiskUsage	NNP
DISM	DISM	NNP
DisMax	DisMax	NNP
Disqus	Disqus	NNP
distcc	distcc	NNP
DistCp	DistCp	NNP
distriqt	distriqt	NNP
Distro	Distro	NNP
Divio	Divio	NNP
DivShot	DivShot	NNP
DJGPP	DJGPP	NNP
Djinni	Djinni	NNP
Django	Django	NNP
DjVu	DjVu	NNP
DKIM	DKIM	NNP
DLNA	DLNA	NNP
DLTK	DLTK	NNP
DMARC	DMARC	NNP
dnode	dnode	NNP
DNSimple	DNSimple	NNP
Dnsmasq	Dnsmasq	NNP
dnspython	dnspython	NNP
DNSSEC	DNSSEC	NNP
DNVM	DNVM	NNP
DocBlock	DocBlock	NNP
DocBook	DocBook	NNP
DocFX	DocFX	NNP
DockPanel	DockPanel	NNP
Doclet	Doclet	NNP
docopt	docopt	NNP
DocPad	DocPad	NNP
DOcplex	DOcplex	NNP
DocumentDB	DocumentDB	NNP
Documentum	Documentum	NNP
Docusaurus	Docusaurus	NNP
docx	docx	NNP
DojoX	DojoX	NNP
Dokan	Dokan	NNP
dokka	dokka	NNP
dokku	dokku	NNP
DokuWiki	DokuWiki	NNP
DolphinDB	DolphinDB	NNP
doMC	doMC	NNP
DomCrawler	DomCrawler	NNP
dominus	dominus	FW
Domo	Domo	NNP
DOMParser	DOMParser	NNP
dompdf	dompdf	NNP
DOSBox	DOSBox	NNP
DOSGi	DOSGi	NNP
DOSKEY	DOSKEY	NNP
dotCloud	dotCloud	NNP
DotCMIS	DotCMIS	NNP
dotCMS	dotCMS	NNP
dotCover	dotCover	NNP
dotenv	dotenv	NNP
Dotfuscator	Dotfuscator	NNP
dotless	dotless	NNP
DotLiquid	DotLiquid	NNP
dotMemory	dotMemory	NNP
dotnet	dotnet	NNP
DotNetBar	DotNetBar	NNP
DotNetNuke	DotNetNuke	NNP
dotNetRDF	dotNetRDF	NNP
DotNetZip	DotNetZip	NNP
dotPeek	dotPeek	NNP
DotSpatial	DotSpatial	NNP
dotTrace	dotTrace	NNP
DotVVM	DotVVM	NNP
Dozer	Dozer	NNP
DPAPI	DPAPI	NNP
DPDK	DPDK	NNP
dpkg	dpkg	NNP
dpkt	dpkt	NNP
dplyr	dplyr	NNP
dragula	dragula	NNP
drawable	drawable	JJ
drawables	drawable	NNS
DRBD	DRBD	NNP
DreamFactory	DreamFactory	NNP
DreamHost	DreamHost	NNP
DreamSpark	DreamSpark	NNP
Dredd	Dredd	NNP
DrJava	DrJava	NNP
DroneKit	DroneKit	NNP
DropNet	DropNet	NNP
droppable	droppable	JJ
Dropwizard	Dropwizard	NNP
Dropzone	Dropzone	NNP
Drush	Drush	NNP
DryIoc	DryIoc	NNP
dryscrape	dryscrape	NNP
DSIG	DSIG	NNP
DSpace	DSpace	NNP
DSPack	DSPack	NNP
Dspic	Dspic	NNP
Dstore	Dstore	NNP
DSVM	DSVM	NNP
dSYM	dSYM	NNP
dtexec	dtexec	NNP
Duktape	Duktape	NNP
Dulwich	Dulwich	NNP
DUMPBIN	DUMPBIN	NNP
dumpsys	dumpsys	NNP
Dundas	Dundas	NNP
DUnit	DUnit	NNP
Durandal	Durandal	NNP
DVCS	DVCS	NNP
Dwolla	Dwolla	NNP
Dwoo	Dwoo	NNP
DWScript	DWScript	NNP
DXGI	DXGI	NNP
DXVA	DXVA	NNP
Dyalog	Dyalog	NNP
dygraphs	dygraphs	NNP
DYMO	DYMO	NNP
Dymola	Dymola	NNP
DynamoDB	DynamoDB	NNP
Dynamoose	Dynamoose	NNP
Dynatable	Dynatable	NNP
Dynatrace	Dynatrace	NNP
Dynatree	Dynatree	NNP
DynDNS	DynDNS	NNP
Dyno	Dyno	NNP
Dynpro	Dynpro	NNP
EABI	EABI	NNP
EarlGrey	EarlGrey	NNP
EaselJS	EaselJS	NNP
EasyAdmin	EasyAdmin	NNP
EasyGUI	EasyGUI	NNP
EasyHook	EasyHook	NNP
EasyNetQ	EasyNetQ	NNP
EasyPHP	EasyPHP	NNP
EasyPost	EasyPost	NNP
EasyRTC	EasyRTC	NNP
EasyUI	EasyUI	NNP
easyXDM	easyXDM	NNP
Eazfuscator	Eazfuscator	NNP
EBCDIC	EBCDIC	NNP
Ebean	Ebean	NNP
ebextensions	ebextensions	NNP
EBNF	EBNF	NNP
ebooks	ebook	NNS
ebook	ebook	NN
eBPF	eBPF	NNP
ECharts	ECharts	NNP
EchoSign	EchoSign	NNP
EclEmma	EclEmma	NNP
Eclim	Eclim	NNP
EclipseLink	EclipseLink	NNP
ECMAScript	ECMAScript	NNP
ecommerce	ecommerce	NN
eConnect	eConnect	NNP
Ecore	Ecore	NNP
eCryptfs	eCryptfs	NNP
Ecto	Ecto	NNP
Eddystone	Eddystone	NNP
Edeliver	Edeliver	NNP
EDID	EDID	NNP
EDIFACT	EDIFACT	NNP
eDisMax	eDisMax	NNP
editfields	editfield	NNS
editfield	editfield	NN
EDMX	EDMX	NNP
EDSDK	EDSDK	NNP
EEPROM	EEPROM	NNP
Eggdrop	Eggdrop	NNP
EGit	EGit	NNP
Eigen	Eigen	NNP
Eigenclass	Eigenclass	NNP
ejabberd	ejabberd	NNP
EJBCA	EJBCA	NNP
EJBQL	EJBQL	NNP
EJML	EJML	NNP
Ektron	Ektron	NNP
Elassandra	Elassandra	NNP
Elastica	Elastica	NNP
Elasticsearch	Elasticsearch	NNP
Elastix	Elastix	NNP
Elementor	Elementor	NNP
elFinder	elFinder	NNP
Elgamal	Elgamal	NNP
ELGG	ELGG	NNP
Elisp	Elisp	NNP
ELMAH	ELMAH	NNP
Eloqua	Eloqua	NNP
ELPA	ELPA	NNP
Elpy	Elpy	NNP
Embedly	Embedly	NNP
EmberFire	EmberFire	NNP
EMDK	EMDK	NNP
emmeans	emmeans	NNP
EmojiOne	EmojiOne	NNP
Emscripten	Emscripten	NNP
enaml	enaml	NNP
Encog	Encog	NNP
Endeca	Endeca	NNP
ENet	ENet	NNP
Enlive	Enlive	NNP
ENSIME	ENSIME	NNP
EnterpriseDB	EnterpriseDB	NNP
Enthought	Enthought	NNP
EnvDTE	EnvDTE	NNP
Envers	Envers	NNP
ENVI	ENVI	NNP
Envoyer	Envoyer	NNP
Envrmnt	Envrmnt	NNP
enyim	enyim	NNP
Enyo	Enyo	NNP
Eonasdan	Eonasdan	NNP
EPEL	EPEL	NNP
EPiServer	EPiServer	NNP
epoll	epoll	NNP
EPPlus	EPPlus	NNP
Epson	Epson	NNP
EPUB	EPUB	NNP
Epydoc	Epydoc	NNP
Erlang	Erlang	NNP
erlide	erlide	NNP
ERPNext	ERPNext	NNP
Errai	Errai	NNP
Errbot	Errbot	NNP
eRuby	eRuby	NNP
ESAPI	ESAPI	NNP
escpos	escpos	NNP
Eshell	Eshell	NNP
eSpeak	eSpeak	NNP
Esper	Esper	NNP
esqueleto	esqueleto	NNP
Essbase	Essbase	NNP
Estimote	Estimote	NNP
etcd	etcd	NNP
Etherpad	Etherpad	NNP
EUnit	EUnit	NNP
evdevs	evdev	NNS
evdev	evdev	NN
eventbuses	eventbus	NNS
eventbus	eventbus	NN
eventhub	eventhub	NNP
EventKit	EventKit	NNP
EventSource	EventSource	NNP
everyauth	everyauth	NNP
Everyplay	Everyplay	NNP
EViews	EViews	NNP
EvoPDF	EvoPDF	NNP
EvoSuite	EvoSuite	NNP
Exadata	Exadata	NNP
EXASolution	EXASolution	NNP
ExCanvas	ExCanvas	NNP
exceljs	exceljs	NNP
ExecJS	ExecJS	NNP
ExifTool	ExifTool	NNP
Exim	Exim	NNP
ExoPlayer	ExoPlayer	NNP
expdp	expdp	NNP
Exposed	Exposed	NNP
ExpressionEngine	ExpressionEngine	NNP
Expresso	Expresso	NNP
expss	expss	NNP
Exrm	Exrm	NNP
EXSLT	EXSLT	NNP
Extbase	Extbase	NNP
extern	extern	JJ
ExtReact	ExtReact	NNP
Eyeshot	Eyeshot	NNP
EZAudio	EZAudio	NNP
ezSQL	ezSQL	NNP
Facebooker	Facebooker	NNP
Facebox	Facebox	NNP
facter	facter	NNP
Fairplay	Fairplay	NNP
FakeItEasy	FakeItEasy	NNP
Falcor	Falcor	NNP
FancyBox	FancyBox	NNP
fancytree	fancytree	NNP
FANN	FANN	NNP
Fantom	Fantom	NNP
FAPI	FAPI	NNP
Fargate	Fargate	NNP
Farseer	Farseer	NNP
fasm	fasm	NNP
FASTA	FASTA	NNP
Fastboot	Fastboot	NNP
FastClick	FastClick	NNP
FasterCSV	FasterCSV	NNP
FasterXML	FasterXML	NNP
Fastify	Fastify	NNP
Fastjson	Fastjson	NNP
Fastlane	Fastlane	NNP
Fastly	Fastly	NNP
FastMember	FastMember	NNP
FastMM	FastMM	NNP
FASTQ	FASTQ	NNP
FastScroll	FastScroll	NNP
FastSearch	FastSearch	NNP
fastText	fastText	NNP
FatFs	FatFs	NNP
FatJar	FatJar	NNP
FatWire	FatWire	NNP
FBConnect	FBConnect	NNP
fbjs	fbjs	NNP
FCKeditor	FCKeditor	NNP
FeathersJS	FeathersJS	NNP
Fedena	Fedena	NNP
FeedBurner	FeedBurner	NNP
feedjira	feedjira	NNP
Feedly	Feedly	NNP
feedparser	feedparser	NNP
feedzirra	feedzirra	NNP
FeinCMS	FeinCMS	NNP
fennec	fennec	NN
Fenwick	Fenwick	NNP
FFmpeg	FFmpeg	NNP
FFTW	FFTW	NNP
FHIR	FHIR	NNP
FiddlerCore	FiddlerCore	NNP
Figwheel	Figwheel	NNP
FILAB	FILAB	NNP
FileAPI	FileAPI	NNP
Filebeat	Filebeat	NNP
FILEman	FILEman	NNP
FileMerge	FileMerge	NNP
FileNet	FileNet	NNP
FilePond	FilePond	NNP
FileStream	FileStream	NNP
FileZilla	FileZilla	NNP
Finatra	Finatra	NNP
Fiori	Fiori	NNP
FiPy	FiPy	NNP
Firebird	Firebird	NNP
FireBreath	FireBreath	NNP
FireDAC	FireDAC	NNP
Firehose	Firehose	NNP
FireMonkey	FireMonkey	NNP
Firepad	Firepad	NNP
FirePath	FirePath	NNP
FirePHP	FirePHP	NNP
FirewallD	FirewallD	NNP
FireWatir	FireWatir	NNP
FireWire	FireWire	NNP
Firmata	Firmata	NNP
Fisheye	Fisheye	NNP
FishPig	FishPig	NNP
fitdistrplus	fitdistrplus	NNP
FitNesse	FitNesse	NNP
fitSharp	fitSharp	NNP
FIWARE	FIWARE	NNP
Fixpoint	Fixpoint	NNP
FizzBuzz	FizzBuzz	NNP
FLAC	FLAC	NNP
FLANN	FLANN	NNP
Flappy	Flappy	NNP
FlashVars	FlashVars	NNP
flatmap	flatmap	NNP
Flatpak	Flatpak	NNP
flatpickr	flatpickr	NNP
Flattr	Flattr	NNP
flexbox	flexbox	NNP
flexdashboard	flexdashboard	NNP
FlexiGrid	FlexiGrid	NNP
Flexjson	Flexjson	NNP
flexmojos	flexmojos	NNP
FlexPaper	FlexPaper	NNP
flextable	flextable	NNP
FlexUnit	FlexUnit	NNP
Flickity	Flickity	NNP
FlightPHP	FlightPHP	NNP
Flink	Flink	NNP
FlipClock	FlipClock	NNP
Flixel	Flixel	NNP
flot	flot	NNP
flotr	flotr	NNP
Flowable	Flowable	NNP
Flowgear	Flowgear	NNP
flowlayouts	flowlayout	NNS
flowlayout	flowlayout	NN
FlowType	FlowType	NNP
FLTK	FLTK	NNP
Fluentd	Fluentd	NNP
FluentLenium	FluentLenium	NNP
FluidSynth	FluidSynth	NNP
FluorineFx	FluorineFx	NNP
flup	flup	NNP
Flurl	Flurl	NNP
Fluxible	Fluxible	NNP
FLVPlayback	FLVPlayback	NNP
FLWOR	FLWOR	NNP
FlyCapture	FlyCapture	NNP
Flycheck	Flycheck	NNP
Flymake	Flymake	NNP
flyout	flyout	NN
Flyspell	Flyspell	NNP
Flysystem	Flysystem	NNP
FMDB	FMDB	NNP
FMOD	FMOD	NNP
FOAF	FOAF	NNP
Fody	Fody	NNP
FogBugz	FogBugz	NNP
folium	folium	NNP
Fontconfig	Fontconfig	NNP
fontello	fontello	NNP
FontForge	FontForge	NNP
forcats	forcats	NNP
Forex	Forex	NNP
Forfiles	Forfiles	NNP
ForgeRock	ForgeRock	NNP
FormEncode	FormEncode	NNP
FormFlow	FormFlow	NNP
formik	formik	NNP
formio	formio	NNP
FormIt	FormIt	NNP
formly	formly	NNP
Formstack	Formstack	NNP
Formtastic	Formtastic	NNP
fortrabbit	fortrabbit	NNP
Fotorama	Fotorama	NNP
FOUC	FOUC	NNP
FourCC	FourCC	NNP
Foxit	Foxit	NNP
FoxPro	FoxPro	NNP
Foxx	Foxx	NNP
FParsec	FParsec	NNP
FPDF	FPDF	NNP
FPDI	FPDI	NNP
FPGA	FPGA	NNP
fPIC	fPIC	NNP
FQDN	FQDN	NNP
Frama	Frama	NNP
Framerjs	Framerjs	NNP
FreeBASIC	FreeBASIC	NNP
FreeBSD	FreeBSD	NNP
FreeCAD	FreeCAD	NNP
freedesktop	freedesktop	NNP
Freeform	Freeform	NNP
FreeGLUT	FreeGLUT	NNP
FreeImage	FreeImage	NNP
FreeIPA	FreeIPA	NNP
FreePBX	FreePBX	NNP
FreeRADIUS	FreeRADIUS	NNP
FreeRDP	FreeRDP	NNP
FreeRTOS	FreeRTOS	NNP
FreeTDS	FreeTDS	NNP
FreeText	FreeText	NNP
FreeTTS	FreeTTS	NNP
FreeType	FreeType	NNP
Frege	Frege	NNP
Freshdesk	Freshdesk	NNP
FreshMvvm	FreshMvvm	NNP
Frida	Frida	NNP
Frisby	Frisby	NNP
Froala	Froala	NNP
FrontPage	FrontPage	NNP
Froogaloop	Froogaloop	NNP
Froyo	Froyo	NNP
FsCheck	FsCheck	NNP
fsck	fsck	NNP
FSEvents	FSEvents	NNP
FSFS	FSFS	NNP
FSharp	FSharp	NNP
FsLex	FsLex	NNP
fstab	fstab	NNP
FsUnit	FsUnit	NNP
fswatch	fswatch	NNP
FsYacc	FsYacc	NNP
FTDI	FTDI	NNP
FTGL	FTGL	NNP
ftrace	ftrace	NNP
FubuMVC	FubuMVC	NNP
FuelPHP	FuelPHP	NNP
Fulkerson	Fulkerson	NNP
FullCalendar	FullCalendar	NNP
Funq	Funq	NNP
Fusebox	Fusebox	NNP
Fuseki	Fuseki	NNP
FusionAuth	FusionAuth	NNP
FusionCharts	FusionCharts	NNP
FusionPBX	FusionPBX	NNP
futex	futex	NNP
fuzzywuzzy	fuzzywuzzy	NNP
FxCop	FxCop	NNP
FxCopCmd	FxCopCmd	NNP
FXRuby	FXRuby	NNP
Gabor	Gabor	NNP
gacutil	gacutil	NNP
GADT	GADT	NNP
Gaia	Gaia	NNP
Galera	Galera	NNP
Gallio	Gallio	NNP
Gamekit	Gamekit	NNP
gameplay	gameplay	NN
GameSparks	GameSparks	NNP
Gammu	Gammu	NNP
GAMS	GAMS	NNP
Ganache	Ganache	NNP
GANT	GANT	NNP
Gantt	Gantt	NNP
gapi	gapi	NNP
Garmin	Garmin	NNP
GateIn	GateIn	NNP
Gaufrette	Gaufrette	NNP
Gboard	Gboard	NNP
gccgo	gccgo	NNP
GCDWebServer	GCDWebServer	NNP
GChart	GChart	NNP
gcloud	gcloud	NNP
Gcov	Gcov	NNP
gcovr	gcovr	NNP
gcsfuse	gcsfuse	NNP
gcutil	gcutil	NNP
GDataXML	GDataXML	NNP
GDBM	GDBM	NNP
gdbserver	gdbserver	NNP
gdbus	gdbus	NNP
GDCM	GDCM	NNP
GDI+	GDI+	NNP
GdkPixbuf	GdkPixbuf	NNP
GDScript	GDScript	NNP
Geany	Geany	NNP
Gearman	Gearman	NNP
geckodriver	geckodriver	NNP
GeckoFx	GeckoFx	NNP
Gecode	Gecode	NNP
GEDCOM	GEDCOM	NNP
Geddy	Geddy	NNP
gedit	gedit	NNP
GeekTool	GeekTool	NNP
Gekko	Gekko	NNP
GELF	GELF	NNP
Gemalto	Gemalto	NNP
Gembox	Gembox	NNP
Gemfile	Gemfile	NNP
Gemset	Gemset	NNP
gemspecs	gemspecs	NNP
GenBank	GenBank	NNP
GENEOS	GENEOS	NNP
Genesys	Genesys	NNP
GeneXus	GeneXus	NNP
Genshi	Genshi	NNP
Gensim	Gensim	NNP
Genson	Genson	NNP
Gentelella	Gentelella	NNP
Gentoo	Gentoo	NNP
Genymotion	Genymotion	NNP
Geocoder	Geocoder	NNP
Geocoding	Geocoding	NNP
geocomplete	geocomplete	NNP
GeoExt	GeoExt	NNP
geofencing	geofencing	NN
GeoFire	GeoFire	NNP
GeoFirestore	GeoFirestore	NNP
Geohashing	Geohashing	NNP
Geokit	Geokit	NNP
Geomap	Geomap	NNP
GeoMesa	GeoMesa	NNP
GeoNames	GeoNames	NNP
GeoPandas	GeoPandas	NNP
Geopoints	Geopoints	NNP
geopy	geopy	NNP
geoR	geoR	NNP
GeoServer	GeoServer	NNP
GeoSPARQL	GeoSPARQL	NNP
geospatial	geospatial	JJ
geosphere	geosphere	NN
geotagging	geotagging	NN
geotargetting	geotargetting	NN
GeoTIFF	GeoTIFF	NNP
Gephi	Gephi	NNP
Gerrit	Gerrit	NNP
GeSHi	GeSHi	NNP
gevent	gevent	NNP
gforth	gforth	NNP
gfortran	gfortran	NNP
GGally	GGally	NNP
gganimate	gganimate	NNP
ggbiplot	ggbiplot	NNP
ggmap	ggmap	NNP
ggplot	ggplot	NNP
ggplotly	ggplotly	NNP
ggpubr	ggpubr	NNP
ggrepel	ggrepel	NNP
ggridges	ggridges	NNP
ggtern	ggtern	NNP
GGTS	GGTS	NNP
ggvis	ggvis	NNP
GHCi	GHCi	NNP
GHCJS	GHCJS	NNP
GHDL	GHDL	NNP
GhostDoc	GhostDoc	NNP
Ghostscript	Ghostscript	NNP
Gideros	Gideros	NNP
GIDSignIn	GIDSignIn	NNP
Gigya	Gigya	NNP
Gimbal	Gimbal	NNP
gimpfu	gimpfu	NNP
Gini	Gini	NNP
Giphy	Giphy	NNP
Giraph	Giraph	NNP
Gitblit	Gitblit	NNP
GitBook	GitBook	NNP
Gitea	Gitea	NNP
gitignore	gitignore	NNP
gitk	gitk	NNP
GitKraken	GitKraken	NNP
Gitolite	Gitolite	NNP
Gitorious	Gitorious	NNP
Gitosis	Gitosis	NNP
GitPython	GitPython	NNP
GitWeb	GitWeb	NNP
GitX	GitX	NNP
GKSession	GKSession	NNP
gksudo	gksudo	NNP
GlassFish	GlassFish	NNP
GLCM	GLCM	NNP
GLEW	GLEW	NNP
GLFW	GLFW	NNP
glibc	glibc	NNP
GLKit	GLKit	NNP
Glmnet	Glmnet	NNP
glog	glog	NNP
gloox	gloox	NNP
GLPK	GLPK	NNP
GLSL	GLSL	NNP
glTF	glTF	NNP
GlusterFS	GlusterFS	NNP
Glympse	Glympse	NNP
Glyphicons	Glyphicons	NNP
Gmagick	Gmagick	NNP
Gmail	Gmail	NNP
gmaps	gmaps	NNP
GMaven	GMaven	NNP
gMock	gMock	NNP
GMPY	GMPY	NNP
GMSPlace	GMSPlace	NNP
GnuCOBOL	GnuCOBOL	NNP
Gnumeric	Gnumeric	NNP
GnuPG	GnuPG	NNP
gnuplot	gnuplot	NNP
GNUstep	GNUstep	NNP
GnuTLS	GnuTLS	NNP
GoAccess	GoAccess	NNP
GObject	GObject	NNP
GoClipse	GoClipse	NNP
Gocql	Gocql	NNP
Godeps	Godeps	NNP
GoDoc	GoDoc	NNP
Gofmt	Gofmt	NNP
Gogs	Gogs	NNP
GoJS	GoJS	NNP
Rust	Rust	NNP
Go	Go	NNP
GoLand	GoLand	NNP
Golang	Golang	NNP
Gollum	Gollum	NNP
gonic	gonic	NNP
GoodData	GoodData	NNP
Googlebot	Googlebot	NNP
googleVis	googleVis	NNP
googleway	googleway	NNP
GOPATH	GOPATH	NNP
goquery	goquery	NNP
Gora	Gora	NNP
GORM	GORM	NNP
goroutines	goroutine	NNS
goroutine	goroutine	NN
GOSU	GOSU	NNP
Goutte	Goutte	NNP
govendor	govendor	NNP
GPars	GPars	NNP
GPath	GPath	NNP
gperftools	gperftools	NNP
GPflow	GPflow	NNP
GPGME	GPGME	NNP
GPGPU	GPGPU	NNP
GPIB	GPIB	NNP
GPIO	GPIO	NNP
gplots	gplots	NNP
gprof	gprof	NNP
GPRS	GPRS	NNP
gpsd	gpsd	NNP
GraalVM	GraalVM	NNP
Gracenote	Gracenote	NNP
Gradle	Gradle	NNP
gradlew	gradlew	NNP
Grafika	Grafika	NNP
Grakn	Grakn	NNP
GraniteDS	GraniteDS	NNP
GrapesJS	GrapesJS	NNP
gRaphael	gRaphael	NNP
Graphcool	Graphcool	NNP
GraphDB	GraphDB	NNP
GraphDiff	GraphDiff	NNP
GraphEdit	GraphEdit	NNP
GrapheneDB	GrapheneDB	NNP
GraphHopper	GraphHopper	NNP
GraphiQL	GraphiQL	NNP
GraphLab	GraphLab	NNP
GraphML	GraphML	NNP
GraphStream	GraphStream	NNP
GraphView	GraphView	NNP
Graphviz	Graphviz	NNP
GraphX	GraphX	NNP
Grappelli	Grappelli	NNP
Grav	Grav	NNP
Gravatar	Gravatar	NNP
Grazi	Grazi	NNP
greenDAO	greenDAO	NNP
GreenDroid	GreenDroid	NNP
Greenfoot	Greenfoot	NNP
Greengrass	Greengrass	NNP
GreenHopper	GreenHopper	NNP
Greenlets	Greenlets	NNP
greenrobot	greenrobot	NNP
GreenSock	GreenSock	NNP
grepl	grepl	NNP
grequests	grequests	NNP
Gretty	Gretty	NNP
GRIB	GRIB	NNP
gridbaglayouts	gridbaglayout	NNS
gridbaglayout	gridbaglayout	NN
griddler	griddler	NNP
Gridex	Gridex	NNP
gridlayouts	gridlayout	NNS
gridlayout	gridlayout	NN
gridlines	gridline	NNS
Gridster	Gridster	NNP
gridviews	gridview	NNS
gridview	gridview	NN
Gridworld	Gridworld	NNP
GridX	GridX	NNP
GROB	GROB	NNP
Groff	Groff	NNP
Groovydoc	Groovydoc	NNP
GroovyWS	GroovyWS	NNP
groupboxes	groupbox	NNS
groupbox	groupbox	NN
GroupWise	GroupWise	NNP
gRPC	gRPC	NNP
GruntJS	GruntJS	NNP
GSAP	GSAP	NNP
GSMComm	GSMComm	NNP
gSOAP	gSOAP	NNP
Gson	Gson	NNP
gspread	gspread	NNP
GSSAPI	GSSAPI	NNP
gstat	gstat	NNP
GStreamer	GStreamer	NNP
gsutil	gsutil	NNP
gtag	gtag	NNP
GTFS	GTFS	NNP
GtkD	GtkD	NNP
gtkmm	gtkmm	NNP
GTmetrix	GTmetrix	NNP
gtrendsR	gtrendsR	NNP
Guice	Guice	NNP
Guidewire	Guidewire	NNP
Gumby	Gumby	NNP
Gumstix	Gumstix	NNP
Gunicorn	Gunicorn	NNP
Gupshup	Gupshup	NNP
Gurobi	Gurobi	NNP
gvNIX	gvNIX	NNP
GWTP	GWTP	NNP
Haar	Haar	NNP
Hackage	Hackage	NNP
Hackintosh	Hackintosh	NNP
Hacklang	Hacklang	NNP
Hakyll	Hakyll	NNP
Hamachi	Hamachi	NNP
Haml	Haml	NNP
Hammerspoon	Hammerspoon	NNP
Hanami	Hanami	NNP
Handoff	Handoff	NNP
Handsontable	Handsontable	NNP
Haneke	Haneke	NNP
Hangfire	Hangfire	NNP
hapi	hapi	NNP
Happstack	Happstack	NNP
HappyBase	HappyBase	NNP
hardcode	hardcode	NN
HarfBuzz	HarfBuzz	NNP
HashiCorp	HashiCorp	NNP
Hashids	Hashids	NNP
hashmaps	hashmap	NNS
hashmap	hashmap	NN
hashsets	hashset	NNS
hashset	hashset	NN
Hasura	Hasura	NNP
haversine	haversine	NNP
Hawkular	Hawkular	NNP
HAWQ	HAWQ	NNP
Hawtio	Hawtio	NNP
HaxeFlixel	HaxeFlixel	NNP
HAXM	HAXM	NNP
HBase	HBase	NNP
HCatalog	HCatalog	NNP
HDBC	HDBC	NNP
HDFS	HDFS	NNP
HDInsight	HDInsight	NNP
HDMI	HDMI	NNP
HDPI	HDPI	NNP
healpy	healpy	NNP
HealthVault	HealthVault	NNP
heapsort	heapsort	NN
Heapster	Heapster	NNP
Heartbleed	Heartbleed	NNP
heatmaps	heatmap	NNS
heatmap	heatmap	NN
heatmaply	heatmaply	NNP
HeidiSQL	HeidiSQL	NNP
HEIF	HEIF	NNP
heightmaps	heightmap	NNS
heightmap	heightmap	NN
Heredoc	Heredoc	NNP
Heritrix	Heritrix	NNP
HEVC	HEVC	NNP
hexdump	hexdump	NNP
HEXO	HEXO	NNP
Heyzap	Heyzap	NNP
HFS+	HFS+	NNP
hgignore	hgignore	NNP
hgrc	hgrc	NNP
hgweb	hgweb	NNP
HHVM	HHVM	NNP
hidapi	hidapi	NNP
HiDPI	HiDPI	NNP
Hiera	Hiera	NNP
Highcharter	Highcharter	NNP
Highcharts	Highcharts	NNP
HighGUI	HighGUI	NNP
Highmaps	Highmaps	NNP
Highpass	Highpass	NNP
Highrise	Highrise	NNP
Highslide	Highslide	NNP
Highstock	Highstock	NNP
Hijri	Hijri	NNP
HikariCP	HikariCP	NNP
Hilo	Hilo	NNP
Hindley	Hindley	NNP
HipChat	HipChat	NNP
HipHop	HipHop	NNP
Hippomocks	Hippomocks	NNP
hiredis	hiredis	NNP
HiveMQ	HiveMQ	NNP
HiveQL	HiveQL	NNP
HLSL	HLSL	NNP
hmatrix	hmatrix	NNP
Hmisc	Hmisc	NNP
hmmlearn	hmmlearn	NNP
HMVC	HMVC	NNP
Hoare	Hoare	NNP
HockeyApp	HockeyApp	NNP
HOCON	HOCON	NNP
Holo	Holo	NNP
HoloLens	HoloLens	NNP
HoloViews	HoloViews	NNP
Homebrew	Homebrew	NNP
homogenous	homogenous	JJ
homography	homography	NN
Hoogle	Hoogle	NNP
HornetQ	HornetQ	NNP
Hortonworks	Hortonworks	NNP
hostapd	hostapd	NNP
Hostmonster	Hostmonster	NNP
Hotmail	Hotmail	NNP
hotspot	hotspot	NNP
hotswap	hotswap	NNP
HotTowel	HotTowel	NNP
Hough	Hough	NNP
Hpple	Hpple	NNP
hpricot	hpricot	NNP
hspec	hspec	NNP
HSSF	HSSF	NNP
hstore	hstore	NNP
HSTS	HSTS	NNP
htaccess	htaccess	NNP
htdocs	htdocs	NNP
HtmlUnit	HtmlUnit	NNP
htop	htop	NNP
htpasswd	htpasswd	NNP
httparty	httparty	NNP
httpauth	httpauth	NNP
httpclient	httpclient	NNP
httperf	httperf	NNP
Httpful	Httpful	NNP
HTTPie	HTTPie	NNP
HTTPoison	HTTPoison	NNP
HttpOnly	HttpOnly	NNP
HttpSession	HttpSession	NNP
httr	httr	NNP
HTTrack	HTTrack	NNP
Hubot	Hubot	NNP
Hunchentoot	Hunchentoot	NNP
HUnit	HUnit	NNP
HVAD	HVAD	NNP
HWPF	HWPF	NNP
hxcpp	hxcpp	NNP
Hybridauth	Hybridauth	NNP
Hybris	Hybris	NNP
hyperHTML	hyperHTML	NNP
Hyperic	Hyperic	NNP
HyperJaxb	HyperJaxb	NNP
Hyperledger	Hyperledger	NNP
HyperLogLog	HyperLogLog	NNP
Hyperloop	Hyperloop	NNP
hyperopt	hyperopt	NNP
hyperref	hyperref	NNP
Hyperstack	Hyperstack	NNP
Hypertable	Hypertable	NNP
Hystrix	Hystrix	NNP
IaaS	IaaS	NNP
IANA	IANA	NNP
IBAN	IBAN	NNP
iBATIS	iBATIS	NNP
IbPy	IbPy	NNP
iBrokers	iBrokers	NNP
iCACLS	iCACLS	NNP
iCanHaz	iCanHaz	NNP
iCarousel	iCarousel	NNP
icCube	icCube	NNP
Icecast	Icecast	NNP
IcedTea	IcedTea	NNP
ICEfaces	ICEfaces	NNP
Icenium	Icenium	NNP
ICEpdf	ICEpdf	NNP
Icinga	Icinga	NNP
ICMP	ICMP	NNP
iconv	iconv	NNP
IdeaVim	IdeaVim	NNP
IDFA	IDFA	NNP
idHTTP	idHTTP	NNP
Idiorm	Idiorm	NNP
IDML	IDML	NNP
iDoc	iDoc	NNP
IETF	IETF	NNP
IExpress	IExpress	NNP
IGListKit	IGListKit	NNP
IGMP	IGMP	NNP
Igraph	Igraph	NNP
IIOP	IIOP	NNP
IIRF	IIRF	NNP
IISNode	IISNode	NNP
IJulia	IJulia	NNP
IKVM	IKVM	NNP
ILAsm	ILAsm	NNP
ILDasm	ILDasm	NNP
ILMerge	ILMerge	NNP
ILNumerics	ILNumerics	NNP
ILSpy	ILSpy	NNP
iMacros	iMacros	NNP
ImageField	ImageField	NNP
Imageio	Imageio	NNP
ImageJ	ImageJ	NNP
ImageKit	ImageKit	NNP
ImageMagick	ImageMagick	NNP
imagemin	imagemin	NNP
ImageNet	ImageNet	NNP
ImageProcessor	ImageProcessor	NNP
ImageShack	ImageShack	NNP
ImageView	ImageView	NNP
Imagick	Imagick	NNP
iManage	iManage	NNP
IMAPClient	IMAPClient	NNP
IMAPI	IMAPI	NNP
ImapX	ImapX	NNP
imblearn	imblearn	NNP
IMDb	IMDb	NNP
IMDbPY	IMDbPY	NNP
IMEI	IMEI	NNP
iMessage	iMessage	NNP
IMGKit	IMGKit	NNP
imgscalr	imgscalr	NNP
Imgur	Imgur	NNP
Immutables	Immutables	NNP
impdp	impdp	NNP
Impex	Impex	NNP
Implicits	Implicits	NNP
ImpressPages	ImpressPages	NNP
impyla	impyla	NNP
incanter	incanter	NNP
Incapsula	Incapsula	NNP
IncrediBuild	IncrediBuild	NNP
incron	incron	NNP
IndexedDB	IndexedDB	NNP
indic	indic	JJ
Inet	Inet	NNP
inetd	inetd	NNP
inets	inets	NNP
Infiniband	Infiniband	NNP
InfiniDB	InfiniDB	NNP
Infinitest	Infinitest	NNP
Inflector	Inflector	NNP
InfluxDB	InfluxDB	NNP
InfluxQL	InfluxQL	NNP
Infobox	Infobox	NNP
Infobright	Infobright	NNP
InfoBubble	InfoBubble	NNP
InfoPath	InfoPath	NNP
Informatica	Informatica	NNP
InfoSphere	InfoSphere	NNP
InfoVis	InfoVis	NNP
Infragistics	Infragistics	NNP
Infusionsoft	Infusionsoft	NNP
Initio	Initio	NNP
initrd	initrd	NNP
InMobi	InMobi	NNP
Inno	Inno	NNP
inorder	inorder	JJ
inorder	inorder	VB
inordered	inorder	VBD
inordering	inorder	VBG
inordered	inorder	VBN
inorder	inorder	VBP
inorders	inorder	VBZ
inotify	inotify	NNP
inproc	inproc	NNP
INRIA	INRIA	NNP
insmod	insmod	NNP
InSpec	InSpec	NNP
inspectdb	inspectdb	NNP
InstallAware	InstallAware	NNP
InstallShield	InstallShield	NNP
Instamojo	Instamojo	NNP
InstaSharp	InstaSharp	NNP
Intelli	Intelli	NNP
Intellisense	Intellisense	NNP
Intellitest	Intellitest	NNP
IntelliTrace	IntelliTrace	NNP
Interbase	Interbase	NNP
Intermec	Intermec	NNP
interprocess	interprocess	JJ
Intershop	Intershop	NNP
InterSystems	InterSystems	NNP
IntraWeb	IntraWeb	NNP
Invantive	Invantive	NNP
InversifyJS	InversifyJS	NNP
invitable	invitable	JJ
IOCP	IOCP	NNP
IOIO	IOIO	NNP
IOKit	IOKit	NNP
ionCube	ionCube	NNP
Ionicons	Ionicons	NNP
Ionide	Ionide	NNP
ioredis	ioredis	NNP
ioslides	ioslides	NNP
iostat	iostat	NNP
IoTivity	IoTivity	NNP
ipdb	ipdb	NNP
Iperf	Iperf	NNP
IPFS	IPFS	NNP
IPFW	IPFW	NNP
iPhoto	iPhoto	NNP
IPMI	IPMI	NNP
ipmitool	ipmitool	NNP
iPod	iPod	NNP
iPOJO	iPOJO	NNP
IPOPT	IPOPT	NNP
iproute	iproute	NNP
IPsec	IPsec	NNP
iptables	iptables	NNP
IPTC	IPTC	NNP
IPTV	IPTV	NNP
IronMQ	IronMQ	NNP
IronRuby	IronRuby	NNP
Irrlicht	Irrlicht	NNP
ISAM	ISAM	NNP
ISAR	ISAR	NNP
isql	isql	NNP
ITCL	ITCL	NNP
iTerm	iTerm	NNP
iText	iText	NNP
iTextG	iTextG	NNP
iTextSharp	iTextSharp	NNP
iTunes	iTunes	NNP
IvyDE	IvyDE	NNP
iWork	iWork	NNP
IzPack	IzPack	NNP
JAAS	JAAS	NNP
Jackcess	Jackcess	NNP
JacORB	JacORB	NNP
Jaeger	Jaeger	NNP
Jaggery	Jaggery	NNP
Jalali	Jalali	NNP
Jama	Jama	NNP
Jambi	Jambi	NNP
Jammit	Jammit	NNP
Janino	Janino	NNP
Janrain	Janrain	NNP
Jaro	Jaro	NNP
jarsigner	jarsigner	NNP
Jasig	Jasig	NNP
Jasny	Jasny	NNP
Jaspersoft	Jaspersoft	NNP
JASPIC	JASPIC	NNP
Jasypt	Jasypt	NNP
javaagents	javaagent	NNS
javaagent	javaagent	NN
javacpp	javacpp	NNP
javacv	javacv	NNP
javah	javah	NNP
JavaHL	JavaHL	NNP
JavaLite	JavaLite	NNP
JavaMail	JavaMail	NNP
javap	javap	NNP
JavaPlot	JavaPlot	NNP
JavaPNS	JavaPNS	NNP
JavaPoet	JavaPoet	NNP
JavaPOS	JavaPOS	NNP
Javassist	Javassist	NNP
javaw	javaw	NNP
JaVers	JaVers	NNP
Jawr	Jawr	NNP
JAXP	JAXP	NNP
JayData	JayData	NNP
JayDeBeApi	JayDeBeApi	NNP
jBCrypt	jBCrypt	NNP
JBehave	JBehave	NNP
JBeret	JBeret	NNP
JBoss	JBoss	NNP
JBossWS	JBossWS	NNP
jBPM	jBPM	NNP
jcabi	jcabi	NNP
jCarousel	jCarousel	NNP
JCenter	JCenter	NNP
jCIFS	jCIFS	NNP
jclouds	jclouds	NNP
JCodec	JCodec	NNP
JCOP	JCOP	NNP
Jcrop	Jcrop	NNP
JCuda	JCuda	NNP
JDBCRealm	JDBCRealm	NNP
Jdbi	Jdbi	NNP
jdeps	jdeps	NNP
JDOM	JDOM	NNP
JDOQL	JDOQL	NNP
JDWP	JDWP	NNP
Jedis	Jedis	NNP
Jelastic	Jelastic	NNP
jemalloc	jemalloc	NNP
jenssegers	jenssegers	NNP
jeromq	jeromq	NNP
jestjs	jestjs	NNP
jetifier	jetifier	NNP
Jetpack	Jetpack	NNP
Jetson	Jetson	NNP
JExcelApi	JExcelApi	NNP
JEXL	JEXL	NNP
JFace	JFace	NNP
JFlex	JFlex	NNP
JFoenix	JFoenix	NNP
JFrog	JFrog	NNP
JFugue	JFugue	NNP
JFXtras	JFXtras	NNP
JGit	JGit	NNP
JGoodies	JGoodies	NNP
JGraphT	JGraphT	NNP
JGraphX	JGraphX	NNP
jGRASP	jGRASP	NNP
JGrowl	JGrowl	NNP
JHBuild	JHBuild	NNP
JHipster	JHipster	NNP
jHtmlArea	jHtmlArea	NNP
Jide	Jide	NNP
Jigoshop	Jigoshop	NNP
Jint	Jint	NNP
Jison	Jison	NNP
JitPack	JitPack	NNP
Jitsi	Jitsi	NNP
Jitterbit	Jitterbit	NNP
JJWT	JJWT	NNP
JMagick	JMagick	NNP
jmDNS	jmDNS	NNP
JMESPath	JMESPath	NNP
JMeter	JMeter	NNP
JMock	JMock	NNP
JMockit	JMockit	NNP
JModelica	JModelica	NNP
JNAerator	JNAerator	NNP
jnativehook	jnativehook	NNP
jNetPcap	jNetPcap	NNP
JNIEnv	JNIEnv	NNP
JNIWrapper	JNIWrapper	NNP
jnlp	jnlp	NNP
JNotify	JNotify	NNP
JobServer	JobServer	NNP
JOCL	JOCL	NNP
Jodd	Jodd	NNP
JOGL	JOGL	NNP
JointJS	JointJS	NNP
Jolokia	Jolokia	NNP
Jongo	Jongo	NNP
JOSSO	JOSSO	NNP
JotForm	JotForm	NNP
journald	journald	NNP
journaling	journaling	JJ
Jovo	Jovo	NNP
Joyent	Joyent	NNP
jpcap	jpcap	NNP
jPCT	jPCT	NNP
JPDA	JPDA	NNP
JPedal	JPedal	NNP
Jpegoptim	Jpegoptim	NNP
jPOS	jPOS	NNP
JPQL	JPQL	NNP
JProfiler	JProfiler	NNP
JPype	JPype	NNP
jqChart	jqChart	NNP
jqMobi	jqMobi	NNP
jqPlot	jqPlot	NNP
jQTE	jQTE	NNP
JQVmap	JQVmap	NNP
jqXHR	jqXHR	NNP
JRebel	JRebel	NNP
JRockit	JRockit	NNP
JRuby	JRuby	NNP
JRun	JRun	NNP
JSAPI	JSAPI	NNP
jsbin	jsbin	NNP
JSch	JSch	NNP
JScience	JScience	NNP
jscoverage	jscoverage	NNP
JScript	JScript	NNP
JSCS	JSCS	NNP
jsdom	jsdom	NNP
JSDT	JSDT	NNP
JSFiddle	JSFiddle	NNP
JSFL	JSFL	NNP
JSFUnit	JSFUnit	NNP
jSignature	jSignature	NNP
JSLink	JSLink	NNP
JSLint	JSLint	NNP
jSMPP	jSMPP	NNP
JSNI	JSNI	NNP
JSOM	JSOM	NNP
JSONata	JSONata	NNP
jsonfield	jsonfield	NNP
Jsonix	Jsonix	NNP
JSONKit	JSONKit	NNP
JSONLint	JSONLint	NNP
JSONModel	JSONModel	NNP
JsonSlurper	JsonSlurper	NNP
JSONStore	JSONStore	NNP
jsoup	jsoup	NNP
jsPDF	jsPDF	NNP
jsPerf	jsPerf	NNP
jsPlumb	jsPlumb	NNP
jspm	jspm	NNP
jsprit	jsprit	NNP
jspx	jspx	NNP
jSSC	jSSC	NNP
JSSE	JSSE	NNP
JsSIP	JsSIP	NNP
jssor	jssor	NNP
jstat	jstat	NNP
JSTL	JSTL	NNP
jStorage	jStorage	NNP
jsvc	jsvc	NNP
JSXGraph	JSXGraph	NNP
JSZip	JSZip	NNP
JTAPI	JTAPI	NNP
jTDS	jTDS	NNP
JTidy	JTidy	NNP
JTwitter	JTwitter	NNP
Jubula	Jubula	NNP
JUCE	JUCE	NNP
jUDDI	jUDDI	NNP
JugglingDB	JugglingDB	NNP
Juju	Juju	NNP
Jumi	Jumi	NNP
JUNOS	JUNOS	NNP
JupyterHub	JupyterHub	NNP
JustGage	JustGage	NNP
JustMock	JustMock	NNP
JVCL	JVCL	NNP
JVisualVM	JVisualVM	NNP
jwilder	jwilder	NNP
JWrapper	JWrapper	NNP
jWysiwyg	jWysiwyg	NNP
JXcore	JXcore	NNP
Jxls	Jxls	NNP
JXPath	JXPath	NNP
JXTA	JXTA	NNP
JZMQ	JZMQ	NNP
Kaazing	Kaazing	NNP
Kadane	Kadane	NNP
Kademlia	Kademlia	NNP
Kaggle	Kaggle	NNP
KairosDB	KairosDB	NNP
Kaldi	Kaldi	NNP
Kalman	Kalman	NNP
Kaltura	Kaltura	NNP
Kamailio	Kamailio	NNP
kaminari	kaminari	NNP
Kamon	Kamon	NNP
Kanban	Kanban	NNP
Kannel	Kannel	NNP
Kantu	Kantu	NNP
Kapacitor	Kapacitor	NNP
kapt	kapt	NNP
Karabiner	Karabiner	NNP
Karaf	Karaf	NNP
Karatsuba	Karatsuba	NNP
Karnaugh	Karnaugh	NNP
Karp	Karp	NNP
Kartik	Kartik	NNP
Katalon	Katalon	NNP
katanas	katana	NNS
katana	katana	NN
KaTeX	KaTeX	NNP
Katharsis	Katharsis	NNP
Kbuild	Kbuild	NNP
KCachegrind	KCachegrind	NNP
KCFinder	KCFinder	NNP
KDevelop	KDevelop	NNP
KDoc	KDoc	NNP
Keccak	Keccak	NNP
KeePass	KeePass	NNP
Keil	Keil	NNP
Kemal	Kemal	NNP
Kendo	Kendo	NNP
Kentico	Kentico	NNP
Kentor	Kentor	NNP
Keras	Keras	NNP
Kernighan	Kernighan	NNP
kernlab	kernlab	NNP
Keyguard	Keyguard	NNP
keyloggers	keylogger	NNS
keylogger	keylogger	NN
keymappings	keymapping	NNS
keymapping	keymapping	NN
Keypoint	Keypoint	NNP
KeystoneJS	KeystoneJS	NNP
Keytool	Keytool	NNP
KGDB	KGDB	NNP
Kibana	Kibana	NNP
Kinect	Kinect	NNP
Kinesis	Kinesis	NNP
KineticJS	KineticJS	NNP
KingswaySoft	KingswaySoft	NNP
Kinvey	Kinvey	NNP
KissXML	KissXML	NNP
Kitematic	Kitematic	NNP
Kitura	Kitura	NNP
Kivy	Kivy	NNP
Kleene	Kleene	NNP
Kleisli	Kleisli	NNP
Klipfolio	Klipfolio	NNP
Klocwork	Klocwork	NNP
KMDF	KMDF	NNP
Knex	Knex	NNP
KNIME	KNIME	NNP
Knitr	Knitr	NNP
Knopflerfish	Knopflerfish	NNP
KnpMenu	KnpMenu	NNP
Kodein	Kodein	NNP
Kodi	Kodi	NNP
Kofax	Kofax	NNP
koGrid	koGrid	NNP
Kohana	Kohana	NNP
KOIN	KOIN	NNP
Kolmogorov	Kolmogorov	NNP
kombu	kombu	NNP
Komodo	Komodo	NNP
Konva	Konva	NNP
Kony	Kony	NNP
kops	kops	NNP
Kosogor	Kosogor	NNP
Kotless	Kotless	NNP
KotlinPoet	KotlinPoet	NNP
Kotlinx	Kotlinx	NNP
kprobe	kprobe	NNP
kqueue	kqueue	NNP
kramdown	kramdown	NNP
kriging	kriging	NN
krpano	krpano	NNP
Kruskal	Kruskal	NNP
KryoNet	KryoNet	NNP
kSOAP	kSOAP	NNP
KSQL	KSQL	NNP
Ktor	Ktor	NNP
Kube	Kube	NNP
kubeadm	kubeadm	NNP
kubectl	kubectl	NNP
Kubeflow	Kubeflow	NNP
kubelet	kubelet	NNP
Kubespray	Kubespray	NNP
Kubuntu	Kubuntu	NNP
Kudan	Kudan	NNP
Kudu	Kudu	NNP
Kundera	Kundera	NNP
Kura	Kura	NNP
Kurento	Kurento	NNP
kurtosis	kurtosis	NN
Kusto	Kusto	NNP
Kutta	Kutta	NNP
Kylin	Kylin	NNP
LABjs	LABjs	NNP
LabVIEW	LabVIEW	NNP
LabWindows	LabWindows	NNP
Lagom	Lagom	NNP
LALR	LALR	NNP
LambdaJ	LambdaJ	NNP
lambdify	lambdify	NNP
LAMPP	LAMPP	NNP
LanguageTool	LanguageTool	NNP
LAPACK	LAPACK	NNP
LAPACKE	LAPACKE	NNP
lapply	lapply	NNP
laradock	laradock	NNP
Laragon	Laragon	NNP
Lasagne	Lasagne	NNP
launchctl	launchctl	NNP
launchd	launchd	NNP
Lauterbach	Lauterbach	NNP
lavaan	lavaan	NNP
Lawnchair	Lawnchair	NNP
LBPH	LBPH	NNP
LCDUI	LCDUI	NNP
ldapjs	ldapjs	NNP
LDFLAGS	LDFLAGS	NNP
LDIF	LDIF	NNP
Leadbolt	Leadbolt	NNP
leaderboards	leaderboard	NNS
leaderboard	leaderboard	NN
Leadfoot	Leadfoot	NNP
LEADTOOLS	LEADTOOLS	NNP
LeakCanary	LeakCanary	NNP
Leanback	Leanback	NNP
LeanFT	LeanFT	NNP
Leiningen	Leiningen	NNP
leJOS	leJOS	NNP
Leksah	Leksah	NNP
Lektor	Lektor	NNP
LensKit	LensKit	NNP
Leptonica	Leptonica	NNP
Lerna	Lerna	NNP
lessphp	lessphp	NNP
Levenberg	Levenberg	NNP
lftp	lftp	NNP
LGPL	LGPL	NNP
LiClipse	LiClipse	NNP
LIDAR	LIDAR	NNP
Lidgren	Lidgren	NNP
Lifelog	Lifelog	NNP
Liferay	Liferay	NNP
Lightbox	Lightbox	NNP
LightGBM	LightGBM	NNP
LightOpenID	LightOpenID	NNP
Lightsail	Lightsail	NNP
Lightspeed	Lightspeed	NNP
LightSwitch	LightSwitch	NNP
lighttpd	lighttpd	NNP
LikeBox	LikeBox	NNP
Likert	Likert	NNP
LilyPond	LilyPond	NNP
LimeJS	LimeJS	NNP
LimeSurvey	LimeSurvey	NNP
LIMMA	LIMMA	NNP
Linaro	Linaro	NNP
linearlayouts	linearlayout	NNS
linearlayout	linearlayout	NN
LineSeries	LineSeries	NNP
LinguaPlone	LinguaPlone	NNP
linkbuttons	linkbutton	NNS
linkbutton	linkbutton	NN
Linkify	Linkify	NNP
linklabels	linklabel	NNS
linklabel	linklabel	NN
Linode	Linode	NNP
Linphone	Linphone	NNP
LINQ	LINQ	NNP
LINQKit	LINQKit	NNP
LINQPad	LINQPad	NNP
Linuxbrew	Linuxbrew	NNP
LiPo	LiPo	NNP
Liquibase	Liquibase	NNP
Liquidsoap	Liquidsoap	NNP
LIRC	LIRC	NNP
LispWorks	LispWorks	NNP
LISTAGG	LISTAGG	NNP
listviews	listview	NNS
listview	listview	NN
LiteDB	LiteDB	NNP
LiteSpeed	LiteSpeed	NNP
LitJSON	LitJSON	NNP
LiveBindings	LiveBindings	NNP
LiveCharts	LiveCharts	NNP
LiveChat	LiveChat	NNP
LiveCode	LiveCode	NNP
LiveConnect	LiveConnect	NNP
LiveCycle	LiveCycle	NNP
LiveData	LiveData	NNP
LiveLink	LiveLink	NNP
livequery	livequery	NNP
LiveReload	LiveReload	NNP
LiveScript	LiveScript	NNP
LiveWires	LiveWires	NNP
LLBLGen	LLBLGen	NNP
LMAX	LMAX	NNP
LMDB	LMDB	NNP
Lmfit	Lmfit	NNP
LocalDB	LocalDB	NNP
LocalServer	LocalServer	NNP
LocalStack	LocalStack	NNP
Localytics	Localytics	NNP
LockBits	LockBits	NNP
lockless	lockless	JJ
lockscreens	lockscreen	NNS
lockscreen	lockscreen	NN
LocomotiveCMS	LocomotiveCMS	NNP
LocomotiveJS	LocomotiveJS	NNP
LOESS	LOESS	NNP
LogCat	LogCat	NNP
Logentries	Logentries	NNP
Loggly	Loggly	NNP
LogLog	LogLog	NNP
logrotate	logrotate	NNP
logstash	logstash	NNP
LokiJS	LokiJS	NNP
lookaheads	lookahead	NNS
lookahead	lookahead	NN
lookbehinds	lookbehind	NNS
lookbehind	lookbehind	NN
lookarounds	lookaround	NNS
lookaround	lookaround	NN
Looper	Looper	NNP
LoopJ	LoopJ	NNP
LoRaWAN	LoRaWAN	NNP
LotusScript	LotusScript	NNP
LPeg	LPeg	NNP
lsmeans	lsmeans	NNP
lsof	lsof	NNP
LSTM	LSTM	NNP
LTPA	LTPA	NNP
ltrace	ltrace	NNP
LTTng	LTTng	NNP
luabind	luabind	NNP
LuaBridge	LuaBridge	NNP
luac	luac	NNP
Luaj	Luaj	NNP
LuaJava	LuaJava	NNP
LuaJIT	LuaJIT	NNP
LuaRocks	LuaRocks	NNP
LuaSocket	LuaSocket	NNP
LuaSQL	LuaSQL	NNP
lubridate	lubridate	NNP
Lucee	Lucee	NNP
Lucidworks	Lucidworks	NNP
LUKS	LUKS	NNP
Lumia	Lumia	NNP
Luminus	Luminus	NNP
lwIP	lwIP	NNP
LWJGL	LWJGL	NNP
LWRP	LWRP	NNP
LWUIT	LWUIT	NNP
lxml	lxml	NNP
Lync	Lync	NNP
LZMA	LZMA	NNP
Maatwebsite	Maatwebsite	NNP
MachineKey	MachineKey	NNP
macOS	macOS	NNP
MacPorts	MacPorts	NNP
Macromedia	Macromedia	NNP
MacRuby	MacRuby	NNP
MacVim	MacVim	NNP
macvlan	macvlan	NNP
Maemo	Maemo	NNP
Magick++	Magick++	NNP
MagickWand	MagickWand	NNP
MagicMock	MagicMock	NNP
MagicSuggest	MagicSuggest	NNP
Magit	Magit	NNP
Magmi	Magmi	NNP
Magnific	Magnific	NNP
magrittR	magrittR	NNP
Mahalanobis	Mahalanobis	NNP
MahApps	MahApps	NNP
Mahotas	Mahotas	NNP
Mailboxer	Mailboxer	NNP
MailCatcher	MailCatcher	NNP
MailCore	MailCore	NNP
Maildir	Maildir	NNP
Mailgun	Mailgun	NNP
Mailjet	Mailjet	NNP
MailKit	MailKit	NNP
mailx	mailx	NNP
MakeCert	MakeCert	NNP
Mako	Mako	NNP
MAMP	MAMP	NNP
MangoDB	MangoDB	NNP
ManifoldCF	ManifoldCF	NNP
Manjaro	Manjaro	NNP
MANOVA	MANOVA	NNP
Mapbox	Mapbox	NNP
MapDB	MapDB	NNP
MAPI	MAPI	NNP
MapInfo	MapInfo	NNP
MapKit	MapKit	NNP
Mapnik	Mapnik	NNP
MapPoint	MapPoint	NNP
MapQuest	MapQuest	NNP
MapR	MapR	NNP
MapReduce	MapReduce	NNP
mapsforge	mapsforge	NNP
MapStruct	MapStruct	NNP
MapTiler	MapTiler	NNP
MapTools	MapTools	NNP
mapviews	mapview	NNS
mapview	mapview	NN
MariaDB	MariaDB	NNP
MariaSQL	MariaSQL	NNP
MarkerClusterer	MarkerClusterer	NNP
Marketo	Marketo	NNP
markItUp	markItUp	NNP
MarkLogic	MarkLogic	NNP
Marko	Marko	NNP
Marquardt	Marquardt	NNP
Mashape	Mashape	NNP
MASM	MASM	NNP
MassMail	MassMail	NNP
MassPay	MassPay	NNP
MassTransit	MassTransit	NNP
matcaffe	matcaffe	NNP
MatConvNet	MatConvNet	NNP
MaterialDrawer	MaterialDrawer	NNP
Mathematica	Mathematica	NNP
MathGL	MathGL	NNP
MathJax	MathJax	NNP
MathJS	MathJS	NNP
MathLink	MathLink	NNP
MathML	MathML	NNP
MathProg	MathProg	NNP
MathQuill	MathQuill	NNP
MathType	MathType	NNP
MATLAB	MATLAB	NNP
Matomo	Matomo	NNP
Matroska	Matroska	NNP
Mattermost	Mattermost	NNP
Mautic	Mautic	NNP
Maven	Maven	NNP
MAVLink	MAVLink	NNP
Maxent	Maxent	NNP
MaxMind	MaxMind	NNP
MAXScript	MAXScript	NNP
MayaVi	MayaVi	NNP
MBaaS	MBaaS	NNP
MBeans	MBeans	NNP
Mbed	Mbed	NNP
mbox	mbox	NNP
MBTiles	MBTiles	NNP
MbUnit	MbUnit	NNP
MCMC	MCMC	NNP
mcrypt	mcrypt	NNP
MDBG	MDBG	NNP
mDNS	mDNS	NNP
MDPI	MDPI	NNP
MeCab	MeCab	NNP
MechanicalSoup	MechanicalSoup	NNP
MediaCodec	MediaCodec	NNP
MediaFire	MediaFire	NNP
MediaInfo	MediaInfo	NNP
MediatR	MediatR	NNP
MediaWiki	MediaWiki	NNP
Medoo	Medoo	NNP
MeeGo	MeeGo	NNP
MELPA	MELPA	NNP
MemBase	MemBase	NNP
MemcacheDB	MemcacheDB	NNP
Memcheck	Memcheck	NNP
MemSQL	MemSQL	NNP
MEncoder	MEncoder	NNP
Mendeley	Mendeley	NNP
menhir	menhir	NN
Merb	Merb	NNP
mergesort	mergesort	NN
mergetool	mergetool	NNP
MERN	MERN	NNP
Mersenne	Mersenne	NNP
MeshLab	MeshLab	NNP
MESI	MESI	NNP
Mesos	Mesos	NNP
messageboxes	messagebox	NNS
messagebox	messagebox	NN
MessageKit	MessageKit	NNP
MessagePack	MessagePack	NNP
MessageUI	MessageUI	NNP
Metabase	Metabase	NNP
metafiles	metafile	NNS
metafile	metafile	NN
Metaio	Metaio	NNP
MetalKit	MetalKit	NNP
Metalsmith	Metalsmith	NNP
MetaMask	MetaMask	NNP
metamodels	metamodel	NNS
metamodel	metamodel	NN
Metaphone	Metaphone	NNP
metaphors	metaphor	NNS
metaphor	metaphor	NN
metaprogramming	metaprogramming	NN
Metasploit	Metasploit	NNP
metastore	metastore	NNP
metatables	metatable	NNS
metatable	metatable	NN
Metis	Metis	NNP
MetPy	MetPy	NNP
Metricbeat	Metricbeat	NNP
Metronic	Metronic	NNP
MFCC	MFCC	NNP
mgcv	mgcv	NNP
MGTwitterEngine	MGTwitterEngine	NNP
mgwt	mgwt	NNP
MHTML	MHTML	NNP
microbenchmark	microbenchmark	NNP
MicroBlaze	MicroBlaze	NNP
MicroC	MicroC	NNP
microdata	microdata	NN
microformat	microformat	NN
Microformats	Microformats	NNP
microkernels	microkernel	NNS
microkernel	microkernel	NN
Micronaut	Micronaut	NNP
MicroProfile	MicroProfile	NNP
MicroPython	MicroPython	NNP
MicroStrategy	MicroStrategy	NNP
Midje	Midje	NNP
MIDL	MIDL	NNP
MIDlet	MIDlet	NNP
MIDP	MIDP	NNP
Mifare	Mifare	NNP
miglayouts	miglayout	NNPS
miglayout	miglayout	NNP
MigraDoc	MigraDoc	NNP
Migrator	Migrator	NNP
MikroC	MikroC	NNP
MikroTik	MikroTik	NNP
MiKTeX	MiKTeX	NNP
Milner	Milner	NNP
MimeKit	MimeKit	NNP
Mindstorms	Mindstorms	NNP
Minecraft	Minecraft	NNP
MinHash	MinHash	NNP
minibuffer	minibuffer	NNP
Miniconda	Miniconda	NNP
minidom	minidom	NNP
minidump	minidump	NNP
minifier	minifier	NN
miniKanren	miniKanren	NNP
Minikube	Minikube	NNP
MiniMagick	MiniMagick	NNP
Minimax	Minimax	NNP
Minimongo	Minimongo	NNP
Mininet	Mininet	NNP
MinIO	MinIO	NNP
MiniProfiler	MiniProfiler	NNP
Minishift	Minishift	NNP
Minitab	Minitab	NNP
minitest	minitest	NNP
Minix	Minix	NNP
MiniZinc	MiniZinc	NNP
Mintty	Mintty	NNP
Mipmaps	Mipmaps	NNP
Miracast	Miracast	NNP
mIRC	mIRC	NNP
MISRA	MISRA	NNP
Mithril	Mithril	NNP
mitmproxy	mitmproxy	NNP
MIUI	MIUI	NNP
mixins	mixins	NNP
MixItUp	MixItUp	NNP
Mixpanel	Mixpanel	NNP
MJML	MJML	NNP
MJPEG	MJPEG	NNP
mLab	mLab	NNP
mlcp	mlcp	NNP
MLeap	MLeap	NNP
MLflow	MLflow	NNP
mlogit	mlogit	NNP
mlpack	mlpack	NNP
mlxtend	mlxtend	NNP
MMAPI	MMAPI	NNP
Mnesia	Mnesia	NNP
MNIST	MNIST	NNP
MobaXterm	MobaXterm	NNP
Mobclix	Mobclix	NNP
Mobfox	Mobfox	NNP
Mobicents	Mobicents	NNP
MobileIron	MobileIron	NNP
MobileNet	MobileNet	NNP
mobileprovision	mobileprovision	NNP
mobiscroll	mobiscroll	NNP
MobX	MobX	NNP
MochiWeb	MochiWeb	NNP
Mockjax	Mockjax	NNP
MockK	MockK	NNP
MockMvc	MockMvc	NNP
MockServer	MockServer	NNP
mockups	mockup	NNS
mockup	mockup	NN
Modbus	Modbus	NNP
Modelica	Modelica	NNP
modeline	modeline	NNP
Modelio	Modelio	NNP
ModelSim	ModelSim	NNP
Modernizr	Modernizr	NNP
ModeShape	ModeShape	NNP
MODX	MODX	NNP
mogenerator	mogenerator	NNP
mogrify	mogrify	NNP
MoinMoin	MoinMoin	NNP
Mojarra	Mojarra	NNP
Mojibake	Mojibake	NNP
Mojolicious	Mojolicious	NNP
Moleculer	Moleculer	NNP
Momentics	Momentics	NNP
Monaca	Monaca	NNP
MonetDB	MonetDB	NNP
MonetDBLite	MonetDBLite	NNP
MongoAlchemy	MongoAlchemy	NNP
mongodump	mongodump	NNP
MongoEngine	MongoEngine	NNP
mongoexport	mongoexport	NNP
MongoHQ	MongoHQ	NNP
Mongoid	Mongoid	NNP
mongojs	mongojs	NNP
MongoKit	MongoKit	NNP
mongolite	mongolite	NNP
MongoMapper	MongoMapper	NNP
mongoosastic	mongoosastic	NNP
mongorestore	mongorestore	NNP
mongoskin	mongoskin	NNP
MongoVUE	MongoVUE	NNP
Monit	Monit	NNP
Monix	Monix	NNP
MonoDevelop	MonoDevelop	NNP
MonoGame	MonoGame	NNP
Monolog	Monolog	NNP
MonoMAC	MonoMAC	NNP
monomorphism	monomorphism	NN
MonoTorrent	MonoTorrent	NNP
MonoTouch	MonoTouch	NNP
MooTools	MooTools	NNP
Moovweb	Moovweb	NNP
MoPub	MoPub	NNP
Moqui	Moqui	NNP
MoreLINQ	MoreLINQ	NNP
Morfologik	Morfologik	NNP
Morphic	Morphic	NNP
mosby	mosby	NNP
Mosca	Mosca	NNP
MOSEK	MOSEK	NNP
Moshi	Moshi	NNP
Mosquitto	Mosquitto	NNP
MoSync	MoSync	NNP
Moto	Moto	NNP
MouseClick	MouseClick	NNP
MouseEvent	MouseEvent	NNP
MoveIt	MoveIt	NNP
Movesense	Movesense	NNP
Movieclips	Movieclips	NNP
MoviePy	MoviePy	NNP
Movilizer	Movilizer	NNP
moxios	moxios	NNP
Moxy	Moxy	NNP
Moya	Moya	NNP
mozrepl	mozrepl	NNP
mPDF	mPDF	NNP
MPEG	MPEG	NNP
MPFR	MPFR	NNP
MPICH	MPICH	NNP
mpiexec	mpiexec	NNP
MPLAB	MPLAB	NNP
MPlayer	MPlayer	NNP
mpmath	mpmath	NNP
MPNs	MPNs	NNP
MPTT	MPTT	NNP
MPXJ	MPXJ	NNP
mrjob	mrjob	NNP
MRTK	MRTK	NNP
mruby	mruby	NNP
MRUnit	MRUnit	NNP
MSAA	MSAA	NNP
MSAL	MSAL	NNP
MSBI	MSBI	NNP
MSBuild	MSBuild	NNP
MSChart	MSChart	NNP
MSDE	MSDE	NNP
msdeploy	msdeploy	NNP
MSDN	MSDN	NNP
MSDTC	MSDTC	NNP
MSER	MSER	NNP
msgpack	msgpack	NNP
MSHTML	MSHTML	NNP
msiexec	msiexec	NNP
MSISDN	MSISDN	NNP
MSMQ	MSMQ	NNP
MSON	MSON	NNP
MSpec	MSpec	NNP
MSTest	MSTest	NNP
mstsc	mstsc	NNP
MSXML	MSXML	NNP
msxsl	msxsl	NNP
MSYS	MSYS	NNP
msysGit	msysGit	NNP
MTOM	MTOM	NNP
Muenchian	Muenchian	NNP
MuleSoft	MuleSoft	NNP
Multer	Multer	NNP
MultiBinding	MultiBinding	NNP
MultiBoot	MultiBoot	NNP
Multibranch	Multibranch	NNP
multibyte	multibyte	JJ
multiclass	multiclass	JJ
multicore	multicore	JJ
multidex	multidex	NNP
MultiKey	MultiKey	NNP
multimethod	multimethod	NN
multinomial	multinomial	JJ
Multipeer	Multipeer	NNP
Multiplatform	Multiplatform	NNP
Multiprecision	Multiprecision	NNP
multirow	multirow	NNP
multisampling	multisampling	NN
MultiScreen	MultiScreen	NNP
Multiselect	Multiselect	NNP
Multisite	Multisite	NNP
MultiStore	MultiStore	NNP
multitargeting	multitargeting	JJ
multitexturing	multitexturing	NN
multithreading	multithreading	NN
MultiView	MultiView	NNP
Multiway	Multiway	NNP
Munin	Munin	NNP
MUNIT	MUNIT	NNP
MuPAD	MuPAD	NNP
MuPDF	MuPDF	NNP
Mura	Mura	NNP
MurmurHash	MurmurHash	NNP
MusicBrainz	MusicBrainz	NNP
MusicKit	MusicKit	NNP
MusicXML	MusicXML	NNP
musl	musl	NNP
mutators	mutator	NNS
mutator	mutator	NN
muxers	muxer	NNS
muxer	muxer	NN
MVCC	MVCC	NNP
MVEL	MVEL	NNP
MVVM	MVVM	NNP
MvvmCross	MvvmCross	NNP
mxGraph	mxGraph	NNP
mxmlc	mxmlc	NNP
MXNet	MXNet	NNP
MyBB	MyBB	NNP
MyFaces	MyFaces	NNP
MyISAM	MyISAM	NNP
Mylyn	Mylyn	NNP
MYOB	MYOB	NNP
Mypy	Mypy	NNP
MySpace	MySpace	NNP
MySQL++	MySQL++	NNP
mysqladmin	mysqladmin	NNP
MySQLi	MySQLi	NNP
mysqljs	mysqljs	NNP
mysqlnd	mysqlnd	NNP
MySQLTuner	MySQLTuner	NNP
NaCl	NaCl	NNP
Nagios	Nagios	NNP
Nagle	Nagle	NNP
Namecheap	Namecheap	NNP
nameko	nameko	NNP
Nanoc	Nanoc	NNP
NanoHttpd	NanoHttpd	NNP
nanomsg	nanomsg	NNP
NAnt	NAnt	NNP
NAntContrib	NAntContrib	NNP
NASM	NASM	NNP
NativeCall	NativeCall	NNP
NativeScript	NativeScript	NNP
NATS	NATS	NNP
NatTable	NatTable	NNP
Natvis	Natvis	NNP
navbar	navbar	NNP
Navicat	Navicat	NNP
Navision	Navision	NNP
Navisworks	Navisworks	NNP
NavMesh	NavMesh	NNP
nawk	nawk	NNP
NCalc	NCalc	NNP
NCover	NCover	NNP
NCrunch	NCrunch	NNP
ncurses	ncurses	NNP
NDEF	NDEF	NNP
NDIS	NDIS	NNP
ndjson	ndjson	NNP
Neato	Neato	NNP
Necessitas	Necessitas	NNP
NeDB	NeDB	NNP
Negamax	Negamax	NNP
Neko	Neko	FW
Nelmio	Nelmio	NNP
Nemerle	Nemerle	NNP
neography	neography	NN
NeoLoad	NeoLoad	NNP
neomodel	neomodel	NNP
Neovim	Neovim	NNP
NerdDinner	NerdDinner	NNP
nerdtree	nerdtree	NNP
NesC	NesC	NNP
NEsper	NEsper	NNP
Nessus	Nessus	NNP
NestJS	NestJS	NNP
NetApp	NetApp	NNP
NetBeans	NetBeans	NNP
NetBSD	NetBSD	NNP
Netcat	Netcat	NNP
NetCDF	NetCDF	NNP
NETCONF	NETCONF	NNP
Netduino	Netduino	NNP
Netezza	Netezza	NNP
Netfilter	Netfilter	NNP
NetFlow	NetFlow	NNP
Netlify	Netlify	NNP
NetLink	NetLink	NNP
NetLogo	NetLogo	NNP
NETMOD	NETMOD	NNP
NetMQ	NetMQ	NNP
netrw	netrw	NNP
NetScaler	NetScaler	NNP
Netsh	Netsh	NNP
Netstat	Netstat	NNP
NetSuite	NetSuite	NNP
Nette	Nette	NNP
netTiers	netTiers	NNP
NetWeaver	NetWeaver	NNP
NetWire	NetWire	NNP
NetworkX	NetworkX	NNP
Netzke	Netzke	NNP
Neumann	Neumann	NNP
NEventStore	NEventStore	NNP
Nexmo	Nexmo	NNP
NextGen	NextGen	NNP
Nextpeer	Nextpeer	NNP
NexusDB	NexusDB	NNP
ngCloak	ngCloak	NNP
Ngen	Ngen	NNP
ngFor	ngFor	NNP
ngMock	ngMock	NNP
ngModel	ngModel	NNP
ngrok	ngrok	NNP
NgRx	NgRx	NNP
NGUI	NGUI	NNP
NGXS	NGXS	NNP
NgZone	NgZone	NNP
NHapi	NHapi	NNP
NHibernate	NHibernate	NNP
NicEdit	NicEdit	NNP
NiFi	NiFi	NNP
NIfTI	NIfTI	NNP
NiftyNet	NiftyNet	NNP
Nightwatch	Nightwatch	NNP
Ning	Ning	NNP
Ninject	Ninject	NNP
Nintex	Nintex	NNP
Nios	Nios	NNP
nivo	nivo	NNP
NixOS	NixOS	NNP
Nixpkgs	Nixpkgs	NNP
nlme	nlme	NNP
NLog	NLog	NNP
nlohmann	nlohmann	NNP
NLopt	NLopt	NNP
NLTK	NLTK	NNP
NLua	NLua	NNP
Nmap	Nmap	NNP
NMEA	NMEA	NNP
NMock	NMock	NNP
NOAA	NOAA	NNP
nock	nock	NNP
NodeApi	NodeApi	NNP
NodeBB	NodeBB	NNP
Nodeclipse	Nodeclipse	NNP
NodeGit	NodeGit	NNP
Nodejitsu	Nodejitsu	NNP
Nodemailer	Nodemailer	NNP
nodemon	nodemon	NNP
nodetool	nodetool	NNP
nodeunit	nodeunit	NNP
NoFlo	NoFlo	NNP
nohup	nohup	NNP
noir	noir	FW
Nokia	Nokia	NNP
Nokogiri	Nokogiri	NNP
nolearn	nolearn	NNP
NoMachine	NoMachine	NNP
Nominatim	Nominatim	NNP
nonblocking	nonblocking	JJ
noncopyable	noncopyable	JJ
nopCommerce	nopCommerce	NNP
normalizr	normalizr	NNP
Northwind	Northwind	NNP
NoSQL	NoSQL	NNP
NotORM	NotORM	NNP
Noty	Noty	NNP
Novacode	Novacode	NNP
Novell	Novell	NNP
noweb	noweb	NNP
NowJS	NowJS	NNP
NPAPI	NPAPI	NNP
Npgsql	Npgsql	NNP
NPoco	NPoco	NNP
NPOI	NPOI	NNP
NReco	NReco	NNP
nREPL	nREPL	NNP
NRPE	NRPE	NNP
NRVO	NRVO	NNP
Nrwl	Nrwl	NNP
Nsight	Nsight	NNP
NSIS	NSIS	NNP
Nspire	Nspire	NNP
NSSM	NSSM	NNP
ntdll	ntdll	NNP
NTFS	NTFS	NNP
NTLM	NTLM	NNP
ntpd	ntpd	NNP
Nucleo	Nucleo	NNP
Nuclide	Nuclide	NNP
NuGet	NuGet	NNP
Nuitka	Nuitka	NNP
NUMA	NUMA	NNP
Numba	Numba	NNP
Numerics	Numerics	NNP
numexpr	numexpr	NNP
NUnit	NUnit	NNP
Nunjucks	Nunjucks	NNP
NuoDB	NuoDB	NNP
NuPIC	NuPIC	NNP
NURBS	NURBS	NNP
NuSMV	NuSMV	NNP
NuSOAP	NuSOAP	NNP
nuspec	nuspec	NNP
Nutch	Nutch	NNP
Nutiteq	Nutiteq	NNP
Nuxeo	Nuxeo	NNP
NVAPI	NVAPI	NNP
NVCC	NVCC	NNP
NVDA	NVDA	NNP
NVENC	NVENC	NNP
NVIDIA	NVIDIA	NNP
NVMe	NVMe	NNP
nvprof	nvprof	NNP
NXLog	NXLog	NNP
Nyquist	Nyquist	NNP
nyroModal	nyroModal	NNP
OBEX	OBEX	NNP
OBIEE	OBIEE	NNP
objcopy	objcopy	NNP
objdump	objdump	NNP
ObjectARX	ObjectARX	NNP
ObjectDB	ObjectDB	NNP
ObjectScript	ObjectScript	NNP
OBJLoader	OBJLoader	NNP
obout	obout	NNP
OCaml	OCaml	NNP
OCamlbuild	OCamlbuild	NNP
ocamllex	ocamllex	NNP
ocamlyacc	ocamlyacc	NNP
OCCI	OCCI	NNP
ocLazyLoad	ocLazyLoad	NNP
OCLint	OCLint	NNP
OCMock	OCMock	NNP
OCPJP	OCPJP	NNP
OCRA	OCRA	NNP
Ocsigen	Ocsigen	NNP
OCSP	OCSP	NNP
OctoberCMS	OctoberCMS	NNP
octokit	octokit	NNP
OctoPack	OctoPack	NNP
Octopress	Octopress	NNP
octrees	octree	NNS
octree	octree	NN
Oculus	Oculus	NNP
OCUnit	OCUnit	NNP
ODAC	ODAC	NNP
OData	OData	NNP
Odoo	Odoo	NNP
ODROID	ODROID	NNP
oEmbed	oEmbed	NNP
OFBiz	OFBiz	NNP
OGNL	OGNL	NNP
Ohai	Ohai	NNP
OIDC	OIDC	NNP
ojAlgo	ojAlgo	NNP
OkHttp	OkHttp	NNP
Okio	Okio	NNP
Okta	Okta	NNP
Okuma	Okuma	NNP
OLAP	OLAP	NNP
Olingo	Olingo	NNP
OllyDbg	OllyDbg	NNP
OLTP	OLTP	NNP
Oltu	Oltu	NNP
OMNeT++	OMNeT++	NNP
OmniAuth	OmniAuth	NNP
omnibox	omnibox	NNP
OmniFaces	OmniFaces	NNP
omniORB	omniORB	NNP
Omnipay	Omnipay	NNP
OmniSharp	OmniSharp	NNP
Omxplayer	Omxplayer	NNP
OneLogin	OneLogin	NNP
OneSignal	OneSignal	NNP
Oneway	Oneway	NNP
Oniguruma	Oniguruma	NNP
ONNX	ONNX	NNP
ONOS	ONOS	NNP
onsen	onsen	FW
ONVIF	ONVIF	NNP
OOAD	OOAD	NNP
OOCSS	OOCSS	NNP
Ooyala	Ooyala	NNP
Oozie	Oozie	NNP
opalrb	opalrb	NNP
opam	opam	NNP
OPcache	OPcache	NNP
OpenACC	OpenACC	NNP
OpenAir	OpenAir	NNP
OpenAL	OpenAL	NNP
OpenALPR	OpenALPR	NNP
OpenAM	OpenAM	NNP
OpenAPI	OpenAPI	NNP
OpenBD	OpenBD	NNP
OpenBLAS	OpenBLAS	NNP
Openbravo	Openbravo	NNP
OpenBSD	OpenBSD	NNP
OpenBUGS	OpenBUGS	NNP
OpenCart	OpenCart	NNP
OpenCMIS	OpenCMIS	NNP
OpenCms	OpenCms	NNP
OpenCover	OpenCover	NNP
OpenCPU	OpenCPU	NNP
OpenCSV	OpenCSV	NNP
OpenCvSharp	OpenCvSharp	NNP
OpenDaylight	OpenDaylight	NNP
OpenDDS	OpenDDS	NNP
OpenDJ	OpenDJ	NNP
OpenDS	OpenDS	NNP
OpenEars	OpenEars	NNP
OpenEBS	OpenEBS	NNP
OpenEdge	OpenEdge	NNP
OpenEJB	OpenEJB	NNP
OpenEmbedded	OpenEmbedded	NNP
OpenERP	OpenERP	NNP
OpenEXR	OpenEXR	NNP
OpenFaces	OpenFaces	NNP
OpenFeint	OpenFeint	NNP
Openfire	Openfire	NNP
OpenFL	OpenFL	NNP
OpenFlow	OpenFlow	NNP
OpenFOAM	OpenFOAM	NNP
openFrameworks	openFrameworks	NNP
OpenFst	OpenFst	NNP
OpenGL	OpenGL	NNP
OpenGrok	OpenGrok	NNP
openHAB	openHAB	NNP
openiddict	openiddict	NNP
OpenIMAJ	OpenIMAJ	NNP
OpenJFX	OpenJFX	NNP
OpenJPA	OpenJPA	NNP
OpenKinect	OpenKinect	NNP
OpenLaszlo	OpenLaszlo	NNP
OpenLDAP	OpenLDAP	NNP
OpenMAX	OpenMAX	NNP
OpenMDAO	OpenMDAO	NNP
OpenMeetings	OpenMeetings	NNP
OpenMesh	OpenMesh	NNP
OpenModelica	OpenModelica	NNP
OpenMP	OpenMP	NNP
OpenNebula	OpenNebula	NNP
OpenNI	OpenNI	NNP
OpenNLP	OpenNLP	NNP
OpenNMS	OpenNMS	NNP
OpenOffice	OpenOffice	NNP
OpenPGP	OpenPGP	NNP
OpenPose	OpenPose	NNP
openpyxl	openpyxl	NNP
OpenRasta	OpenRasta	NNP
OpenRDF	OpenRDF	NNP
OpenRefine	OpenRefine	NNP
OpenResty	OpenResty	NNP
OpenSAML	OpenSAML	NNP
OpenSC	OpenSC	NNP
OpenSCAD	OpenSCAD	NNP
OpenScript	OpenScript	NNP
OpenSIPS	OpenSIPS	NNP
OpenSL	OpenSL	NNP
OpenSolaris	OpenSolaris	NNP
OpenSSO	OpenSSO	NNP
openSUSE	openSUSE	NNP
OpenTBS	OpenTBS	NNP
OpenTK	OpenTK	NNP
OpenTok	OpenTok	NNP
OpenTracing	OpenTracing	NNP
OpenTripPlanner	OpenTripPlanner	NNP
OpenTSDB	OpenTSDB	NNP
OpenType	OpenType	NNP
OpenURL	OpenURL	NNP
OpenVAS	OpenVAS	NNP
OpenVINO	OpenVINO	NNP
OpenVMS	OpenVMS	NNP
OpenVPN	OpenVPN	NNP
OpenVR	OpenVR	NNP
OpenVZ	OpenVZ	NNP
OpenWebBeans	OpenWebBeans	NNP
OpenWebRTC	OpenWebRTC	NNP
OpenWhisk	OpenWhisk	NNP
OpenX	OpenX	NNP
OpenXava	OpenXava	NNP
openxlsx	openxlsx	NNP
opkg	opkg	NNP
OpLog	OpLog	NNP
OPOS	OPOS	NNP
OPPO	OPPO	NNP
OProfile	OProfile	NNP
OpsCenter	OpsCenter	NNP
OpsHub	OpsHub	NNP
OpsWorks	OpsWorks	NNP
Optimizely	Optimizely	NNP
Optimus	Optimus	NNP
OptiX	OptiX	NNP
optparse	optparse	NNP
oracledb	oracledb	NNP
OrangeHRM	OrangeHRM	NNP
Orbeon	Orbeon	NNP
Orca	Orca	NNP
OrchardCMS	OrchardCMS	NNP
ORDS	ORDS	NNP
OrgChart	OrgChart	NNP
OrientDB	OrientDB	NNP
OrientJS	OrientJS	NNP
Origen	Origen	NNP
Orika	Orika	NNP
OrmLite	OrmLite	NNP
OroCRM	OroCRM	NNP
osascript	osascript	NNP
Osclass	Osclass	NNP
osCommerce	osCommerce	NNP
OSDev	OSDev	NNP
OSGeo	OSGeo	NNP
OSLC	OSLC	NNP
osmdroid	osmdroid	NNP
OSMF	OSMF	NNP
OSMnx	OSMnx	NNP
OSPF	OSPF	NNP
OSQA	OSQA	NNP
OSQL	OSQL	NNP
OSRM	OSRM	NNP
osTicket	osTicket	NNP
otool	otool	NNP
oTree	oTree	NNP
OTRS	OTRS	NNP
OutSystems	OutSystems	NNP
overscroll	overscroll	NN
oVirt	oVirt	NNP
OWIN	OWIN	NNP
ownCloud	ownCloud	NNP
OXID	OXID	NNP
Oxygene	Oxygene	NNP
OxyPlot	OxyPlot	NNP
Ozeki	Ozeki	NNP
PaaS	PaaS	NNP
Packagist	Packagist	NNP
packagr	packagr	NNP
Packery	Packery	NNP
Packetbeat	Packetbeat	NNP
Packrat	Packrat	NNP
pacman	pacman	NNP
Padrino	Padrino	NNP
pafy	pafy	NNP
PageRank	PageRank	NNP
Pagerfanta	Pagerfanta	NNP
PageSpeed	PageSpeed	NNP
Paho	Paho	NNP
Paket	Paket	NNP
PandaBoard	PandaBoard	NNP
Pandasql	Pandasql	NNP
Pandoc	Pandoc	NNP
Pango	Pango	NNP
PangoCairo	PangoCairo	NNP
Panoramio	Panoramio	NNP
Pantheios	Pantheios	NNP
panzoom	panzoom	NNP
Papertrail	Papertrail	NNP
PAPI	PAPI	NNP
Paramiko	Paramiko	NNP
Parasoft	Parasoft	NNP
Parceler	Parceler	NNP
ParcelJS	ParcelJS	NNP
Pardot	Pardot	NNP
ParEdit	ParEdit	NNP
ParseKit	ParseKit	NNP
Parslet	Parslet	NNP
PartCover	PartCover	NNP
partitioner	partitioner	NN
PassKit	PassKit	NNP
passwd	passwd	NNP
Pastebin	Pastebin	NNP
paster	paster	NNP
Pathauto	Pathauto	NNP
pathing	pathing	NN
Paxos	Paxos	NNP
Payara	Payara	NNP
PAYFORT	PAYFORT	NNP
PAYMILL	PAYMILL	NNP
Paytm	Paytm	NNP
PayU	PayU	NNP
Payum	Payum	NNP
PayUmoney	PayUmoney	NNP
Pcap	Pcap	NNP
pChart	pChart	NNP
PCRE	PCRE	NNP
PCSC	PCSC	NNP
PCSpim	PCSpim	NNP
PDCurses	PDCurses	NNP
PDDL	PDDL	NNP
PDFBox	PDFBox	NNP
PDFium	PDFium	NNP
PDFKit	PDFKit	NNP
pdfLaTeX	pdfLaTeX	NNP
PDFMake	PDFMake	NNP
PDFMiner	PDFMiner	NNP
PDFNet	PDFNet	NNP
pdfrw	pdfrw	NNP
PDFsharp	PDFsharp	NNP
PDFtk	PDFtk	NNP
PDFTron	PDFTron	NNP
PDFView	PDFView	NNP
Pechkin	Pechkin	NNP
PECL	PECL	NNP
PeerJS	PeerJS	NNP
Pega	Pega	NNP
PegJS	PegJS	NNP
Pentaho	Pentaho	NNP
PeopleSoft	PeopleSoft	NNP
perceptron	perceptron	NN
Percona	Percona	NNP
PerfMon	PerfMon	NNP
perftools	perftools	NNP
Perlbrew	Perlbrew	NNP
perldoc	perldoc	NNP
Perlin	Perlin	NNP
PerlMagick	PerlMagick	NNP
PerlScript	PerlScript	NNP
PermGen	PermGen	NNP
PetaLinux	PetaLinux	NNP
PetaPoco	PetaPoco	NNP
Petri	Petri	NNP
PETSc	PETSc	NNP
PEVerify	PEVerify	NNP
Pexpect	Pexpect	NNP
pfSense	pfSense	NNP
pgAdmin	pgAdmin	NNP
pgAgent	pgAgent	NNP
pgbouncer	pgbouncer	NNP
pgcrypto	pgcrypto	NNP
pgloader	pgloader	NNP
pgpool	pgpool	NNP
pgRouting	pgRouting	NNP
pgSQL	pgSQL	NNP
Phabricator	Phabricator	NNP
Phalcon	Phalcon	NNP
PHAR	PHAR	NNP
Pharo	Pharo	NNP
Phaser	Phaser	NNP
pHash	pHash	NNP
pheanstalk	pheanstalk	NNP
Phing	Phing	NNP
Phinx	Phinx	NNP
PhoneGap	PhoneGap	NNP
PhoneJS	PhoneJS	NNP
PhoneRTC	PhoneRTC	NNP
Phong	Phong	NNP
photogrammetry	photogrammetry	NN
PhotoKit	PhotoKit	NNP
photologue	photologue	NNP
PhotoSwipe	PhotoSwipe	NNP
PhotoView	PhotoView	NNP
phpass	phpass	NNP
phpBB	phpBB	NNP
phpCAS	phpCAS	NNP
phpcassa	phpcassa	NNP
PHPCR	PHPCR	NNP
phpcs	phpcs	NNP
phpDesigner	phpDesigner	NNP
phpdesktop	phpdesktop	NNP
PHPDoc	PHPDoc	NNP
phpdocx	phpdocx	NNP
PhpED	PhpED	NNP
PHPExcel	PHPExcel	NNP
phpflickr	phpflickr	NNP
phpFox	phpFox	NNP
phpList	phpList	NNP
PHPMailer	PHPMailer	NNP
PHPMD	PHPMD	NNP
phpMyAdmin	phpMyAdmin	NNP
phpspec	phpspec	NNP
PhpStorm	PhpStorm	NNP
PHPTAL	PHPTAL	NNP
PHPUnit	PHPUnit	NNP
phpwkhtmltopdf	phpwkhtmltopdf	NNP
PHPWord	PHPWord	NNP
PHRETS	PHRETS	NNP
Phusion	Phusion	NNP
Phylo	Phylo	NNP
phyloseq	phyloseq	NNP
PhysicsJS	PhysicsJS	NNP
Physijs	Physijs	NNP
PhysX	PhysX	NNP
Picasa	Picasa	NNP
picklists	picklist	NNS
picklist	picklist	NN
Picocli	Picocli	NNP
pika	pika	NNP
Pikaday	Pikaday	NNP
Pimcore	Pimcore	NNP
Pimpl	Pimpl	NNP
Pinax	Pinax	NNP
PinchZoom	PinchZoom	NNP
Pingdom	Pingdom	NNP
PingFederate	PingFederate	NNP
PInvoke	PInvoke	NNP
PipelineDB	PipelineDB	NNP
pipelining	pipelining	NN
Pitest	Pitest	NNP
Pixastic	Pixastic	NNP
Pixate	Pixate	NNP
pixelate	pixelate	VB
pixelated	pixelate	VBD
pixelating	pixelate	VBG
pixelated	pixelate	VBN
pixelate	pixelate	VBP
pixelates	pixelate	VBZ
pixelation	pixelation	NN
PixelSense	PixelSense	NNP
Pixi	Pixi	NNP
PixiJS	PixiJS	NNP
Pixmap	Pixmap	NNP
pjax	pjax	NNP
PJSIP	PJSIP	NNP
PKGBUILD	PKGBUILD	NNP
PKIX	PKIX	NNP
Plack	Plack	NNP
PlantUML	PlantUML	NNP
plasmoids	plasmoid	NNS
plasmoid	plasmoid	NN
PlatformIO	PlatformIO	NNP
PlayN	PlayN	NNP
playorm	playorm	NNP
PlayReady	PlayReady	NNP
playscape	playscape	NNP
Plesk	Plesk	NNP
Plex	Plex	NNP
PLINK	PLINK	NNP
PLINQ	PLINQ	NNP
Plivo	Plivo	NNP
Plone	Plone	NNP
PloneFormGen	PloneFormGen	NNP
Plotly	Plotly	NNP
plotmath	plotmath	NNP
plotnine	plotnine	NNP
plotrix	plotrix	NNP
plottable	plottable	JJ
pluggable	pluggable	JJ
PlugMan	PlugMan	NNP
plumatic	plumatic	NNP
Plunker	Plunker	NNP
Plupload	Plupload	NNP
plyr	plyr	NNP
PMML	PMML	NNP
pngcrush	pngcrush	NNP
pngquant	pngquant	NNP
PNotify	PNotify	NNP
PocketSphinx	PocketSphinx	NNP
POCO	POCO	NNP
Podfile	Podfile	NNP
Podio	Podio	NNP
Podofo	Podofo	NNP
Podspec	Podspec	NNP
PoEAA	PoEAA	NNP
Poedit	Poedit	NNP
POJO	POJO	NNP
Polarion	Polarion	NNP
PolarSSL	PolarSSL	NNP
Policyfiles	Policyfiles	NNP
pollers	poller	NNS
poller	poller	NN
Poloniex	Poloniex	NNP
PolyBase	PolyBase	NNP
polyhedra	polyhedron	NNS
Polylang	Polylang	NNP
Polymerfire	Polymerfire	NNP
polymorphs	polymorph	NNS
polymorph	polymorph	NN
polymorphic	polymorphic	JJ
PonyORM	PonyORM	NNP
Poppler	Poppler	NNP
popupmenus	popupmenu	NNS
popupmenu	popupmenu	NN
Portainer	Portainer	NNP
PortAudio	PortAudio	NNP
PostBack	PostBack	NNP
PostgreSQL	PostgreSQL	NNP
PostgREST	PostgREST	NNP
postorder	postorder	JJ
PostSharp	PostSharp	NNP
PouchDB	PouchDB	NNP
PowerApps	PowerApps	NNP
PowerCenter	PowerCenter	NNP
PowerCLI	PowerCLI	NNP
PowerDesigner	PowerDesigner	NNP
PowerDNS	PowerDNS	NNP
Powerline	Powerline	NNP
Powermail	Powermail	NNP
PowerMock	PowerMock	NNP
PowerMockito	PowerMockito	NNP
PowerPC	PowerPC	NNP
PowerVR	PowerVR	NNP
PPAPI	PPAPI	NNP
pppd	pppd	NNP
pprof	pprof	NNP
PPTP	PPTP	NNP
pptx	pptx	NNP
Praat	Praat	NNP
PRAW	PRAW	NNP
Prawnto	Prawnto	NNP
Preact	Preact	NNP
Prebid	Prebid	NNP
precache	precache	VB
precached	precache	VBD
precaching	precache	VBG
precached	precache	VBN
precache	precache	VBP
precaches	precache	VBZ
PredictionIO	PredictionIO	NNP
Predis	Predis	NNP
Predix	Predix	NNP
Prefuse	Prefuse	NNP
PreloadJS	PreloadJS	NNP
Premailer	Premailer	NNP
Premake	Premake	NNP
preorders	preorder	NNS
preorder	preorder	NN
preprocessing	preprocessing	NN
Prepros	Prepros	NNP
Prerender	Prerender	NNP
PresentationML	PresentationML	NNP
PrestaShop	PrestaShop	NNP
PrettyFaces	PrettyFaces	NNP
prettyPhoto	prettyPhoto	NNP
Prezto	Prezto	NNP
primality	primality	NN
Primavera	Primavera	NNP
PrimeFaces	PrimeFaces	NNP
PrimeNG	PrimeNG	NNP
PrimeReact	PrimeReact	NNP
Prims	Prims	NNP
Primus	Primus	NNP
Prisma	Prisma	NNP
Prismic	Prismic	NNP
PrismJS	PrismJS	NNP
PRNG	PRNG	NNP
ProcDump	ProcDump	NNP
ProcessMaker	ProcessMaker	NNP
ProcessWire	ProcessWire	NNP
Procfile	Procfile	NNP
procfs	procfs	NNP
procmail	procmail	NNP
Procrun	Procrun	NNP
ProFTPD	ProFTPD	NNP
ProGet	ProGet	NNP
ProgramData	ProgramData	NNP
ProGuard	ProGuard	NNP
PROJ	PROJ	NNP
Promela	Promela	NNP
PromiseKit	PromiseKit	NNP
PromQL	PromQL	NNP
protobuf	protobuf	NNP
protoc	protoc	NNP
protorpc	protorpc	NNP
protostuff	protostuff	NNP
prototypal	prototypal	NNP
Protovis	Protovis	NNP
Proxmox	Proxmox	NNP
ProxyPass	ProxyPass	NNP
proxyquire	proxyquire	NNP
ProxySQL	ProxySQL	NNP
psake	psake	NNP
PSCP	PSCP	NNP
pseudocode	pseudocode	NN
PsExec	PsExec	NNP
PSFTP	PSFTP	NNP
PSGI	PSGI	NNP
PSoC	PSoC	NNP
PSPDFKit	PSPDFKit	NNP
psql	psql	NNP
PSSE	PSSE	NNP
PSSnapin	PSSnapin	NNP
psutil	psutil	NNP
PsychoPy	PsychoPy	NNP
Psychtoolbox	Psychtoolbox	NNP
Pthreads	Pthreads	NNP
ptrace	ptrace	NNP
PTVS	PTVS	NNP
PubMed	PubMed	NNP
PubNub	PubNub	NNP
PuDB	PuDB	NNP
pugixml	pugixml	NNP
pugjs	pugjs	NNP
PulseAudio	PulseAudio	NNP
Pulumi	Pulumi	NNP
PuPHPet	PuPHPet	NNP
PuppetLabs	PuppetLabs	NNP
PureMVC	PureMVC	NNP
PureScript	PureScript	NNP
purrr	purrr	NNP
PushBots	PushBots	NNP
PushKit	PushKit	NNP
PushSharp	PushSharp	NNP
Pushwoosh	Pushwoosh	NNP
PVCS	PVCS	NNP
PVRTC	PVRTC	NNP
pxssh	pxssh	NNP
PyAlgoTrade	PyAlgoTrade	NNP
PyAMF	PyAMF	NNP
PyArrow	PyArrow	NNP
PyAudio	PyAudio	NNP
PyBluez	PyBluez	NNP
PyBrain	PyBrain	NNP
pyCaffe	pyCaffe	NNP
Pycairo	Pycairo	NNP
pycassa	pycassa	NNP
pycparser	pycparser	NNP
PyCrypto	PyCrypto	NNP
PyCryptodome	PyCryptodome	NNP
PyCUDA	PyCUDA	NNP
PycURL	PycURL	NNP
PyDev	PyDev	NNP
pydicom	pydicom	NNP
Pydio	Pydio	NNP
pydot	pydot	NNP
PyDrive	PyDrive	NNP
pydub	pydub	NNP
pyenchant	pyenchant	NNP
pyenv	pyenv	NNP
PyEphem	PyEphem	NNP
PyES	PyES	NNP
pyexcel	pyexcel	NNP
PyFacebook	PyFacebook	NNP
PyFCM	PyFCM	NNP
PyFFmpeg	PyFFmpeg	NNP
pyFFTW	pyFFTW	NNP
PyFITS	PyFITS	NNP
Pyflakes	Pyflakes	NNP
Pygal	Pygal	NNP
PyGame	PyGame	NNP
PyGithub	PyGithub	NNP
pyglet	pyglet	NNP
Pygments	Pygments	NNP
PyGraphviz	PyGraphviz	NNP
PyGreSQL	PyGreSQL	NNP
pygsheets	pygsheets	NNP
PyGTK	PyGTK	NNP
PyHive	PyHive	NNP
pyHook	pyHook	NNP
pyinotify	pyinotify	NNP
PyJade	PyJade	NNP
Pyjnius	Pyjnius	NNP
PyJWT	PyJWT	NNP
PyKafka	PyKafka	NNP
pykalman	pykalman	NNP
Pylint	Pylint	NNP
pylintrc	pylintrc	NNP
PyLucene	PyLucene	NNP
Pymacs	Pymacs	NNP
PyMC	PyMC	NNP
PyMEL	PyMEL	NNP
PyModbus	PyModbus	NNP
PyMOL	PyMOL	NNP
PyMongo	PyMongo	NNP
pymssql	pymssql	NNP
Pymunk	Pymunk	NNP
PyMySQL	PyMySQL	NNP
pynotify	pynotify	NNP
pynput	pynput	NNP
PyObjC	PyObjC	NNP
pyodbc	pyodbc	NNP
Pyomo	Pyomo	NNP
PyOpenCL	PyOpenCL	NNP
PyOpenGL	PyOpenGL	NNP
pyOpenSSL	pyOpenSSL	NNP
PyOrient	PyOrient	NNP
pyparsing	pyparsing	NNP
pyPDF	pyPDF	NNP
pyperclip	pyperclip	NNP
PyPI	PyPI	NNP
pyppeteer	pyppeteer	NNP
pyproj	pyproj	NNP
PyPyODBC	PyPyODBC	NNP
PyQt	PyQt	NNP
pyquery	pyquery	NNP
Pyral	Pyral	NNP
Pyrebase	Pyrebase	NNP
pyRevit	pyRevit	NNP
Pyro	Pyro	NNP
PyroCMS	PyroCMS	NNP
PyROOT	PyROOT	NNP
PySAL	PySAL	NNP
pysam	pysam	NNP
pyscard	pyscard	NNP
PyScripter	PyScripter	NNP
pyserial	pyserial	NNP
pysftp	pysftp	NNP
PyShark	PyShark	NNP
PySide	PySide	NNP
pysimplesoap	pysimplesoap	NNP
PySNMP	PySNMP	NNP
Pysolr	Pysolr	NNP
pysqlite	pysqlite	NNP
PySVN	PySVN	NNP
PyTesser	PyTesser	NNP
PyTest	PyTest	NNP
pythonbrew	pythonbrew	NNP
pythoncom	pythoncom	NNP
Pythonista	Pythonista	NNP
PythonMagick	PythonMagick	NNP
pythonw	pythonw	NNP
PyTorch	PyTorch	NNP
pyttsx	pyttsx	NNP
pytube	pytube	NNP
pytz	pytz	NNP
pyudev	pyudev	NNP
pyuic	pyuic	NNP
PyUNO	PyUNO	NNP
PyUSB	PyUSB	NNP
PyVISA	PyVISA	NNP
PyViz	PyViz	NNP
pyVmomi	pyVmomi	NNP
Pywikibot	Pywikibot	NNP
pywinauto	pywinauto	NNP
PyXB	PyXB	NNP
PyYAML	PyYAML	NNP
PyZMQ	PyZMQ	NNP
QBFC	QBFC	NNP
QBWC	QBWC	NNP
qbXML	qbXML	NNP
QEMU	QEMU	NNP
QGIS	QGIS	NNP
QIIME	QIIME	NNP
qmake	qmake	NNP
QNAP	QNAP	NNP
qooxdoo	qooxdoo	NNP
Qpid	Qpid	NNP
QPython	QPython	NNP
quadtree	quadtree	NN
Quagga	Quagga	NNP
QuaggaJS	QuaggaJS	NNP
Qualcomm	Qualcomm	NNP
Quandl	Quandl	NNP
quanteda	quanteda	NNP
quantiles	quantile	NNS
quantile	quantile	NN
quantmod	quantmod	NNP
quantreg	quantreg	NNP
quantstrat	quantstrat	NNP
Quarkus	Quarkus	NNP
Quartus	Quartus	NNP
Quasiquotes	Quasiquotes	NNP
QuaZIP	QuaZIP	NNP
Qubole	Qubole	NNP
Quercus	Quercus	NNP
Querydsl	Querydsl	NNP
QueryPath	QueryPath	NNP
QuestaSim	QuestaSim	NNP
Quickblox	Quickblox	NNP
QuickCheck	QuickCheck	NNP
QuickFIX	QuickFIX	NNP
QuickGraph	QuickGraph	NNP
Quicklisp	Quicklisp	NNP
QuickLook	QuickLook	NNP
QuickSight	QuickSight	NNP
quicksort	quicksort	NN
QuickStart	QuickStart	NNP
QuickTime	QuickTime	NNP
Quil	Quil	NNP
QuTiP	QuTiP	NNP
rabbitmqctl	rabbitmqctl	NNP
RABL	RABL	NNP
Rackspace	Rackspace	NNP
rackup	rackup	NNP
RadChart	RadChart	NNP
RadGrid	RadGrid	NNP
RadRails	RadRails	NNP
RadScheduler	RadScheduler	NNP
RadWindow	RadWindow	NNP
Ragel	Ragel	NNP
RAII	RAII	NNP
Railo	Railo	NNP
RailsApps	RailsApps	NNP
RailsCasts	RailsCasts	NNP
Rainmeter	Rainmeter	NNP
Rajawali	Rajawali	NNP
Raku	Raku	NNP
Rakudo	Rakudo	NNP
Ramaze	Ramaze	NNP
Ramda	Ramda	NNP
RAMDisk	RAMDisk	NNP
RAML	RAML	NNP
Ranorex	Ranorex	NNP
RANSAC	RANSAC	NNP
rApache	rApache	NNP
RapidJSON	RapidJSON	NNP
RapidMiner	RapidMiner	NNP
RapidShare	RapidShare	NNP
RapidXml	RapidXml	NNP
Rappid	Rappid	NNP
Rasa	Rasa	NNP
Rasterbar	Rasterbar	NNP
Rasterio	Rasterio	NNP
rasterVis	rasterVis	NNP
ratingbars	ratingbar	NNS
ratingbar	ratingbar	NN
Ratpack	Ratpack	NNP
Raty	Raty	NNP
Rauth	Rauth	NNP
RavenDB	RavenDB	NNP
Raygun	Raygun	NNP
RazorEngine	RazorEngine	NNP
Razorpay	Razorpay	NNP
RazorPDF	RazorPDF	NNP
RazorSQL	RazorSQL	NNP
RBAC	RBAC	NNP
rbenv	rbenv	NNP
Rblpapi	Rblpapi	NNP
rbokeh	rbokeh	NNP
RCaller	RCaller	NNP
rCharts	rCharts	NNP
RCov	RCov	NNP
Rcpp	Rcpp	NNP
RCPTT	RCPTT	NNP
RCurl	RCurl	NNP
RData	RData	NNP
RDBMS	RDBMS	NNP
RDCOMClient	RDCOMClient	NNP
RDFa	RDFa	NNP
RDFS	RDFS	NNP
RDFStore	RDFStore	NNP
rdiscount	rdiscount	NNP
RDKit	RDKit	NNP
RDLC	RDLC	NNP
RDMA	RDMA	NNP
RDMS	RDMS	NNP
RDoc	RDoc	NNP
reachability	reachability	NN
reactstrap	reactstrap	NNP
readr	readr	NNP
readxl	readxl	NNP
REALbasic	REALbasic	NNP
Realex	Realex	NNP
RealSense	RealSense	NNP
Rebar	Rebar	NNP
REBOL	REBOL	NNP
Recharts	Recharts	NNP
recommender	recommender	NN
RecordRTC	RecordRTC	NNP
recordset	recordset	NN
Recurly	Recurly	NNP
recycler	recycler	NN
Redash	Redash	NNP
RedBean	RedBean	NNP
RedCloth	RedCloth	NNP
Redgate	Redgate	NNP
RedhawkSDR	RedhawkSDR	NNP
Redigo	Redigo	NNP
Redisson	Redisson	NNP
Redland	Redland	NNP
Redmi	Redmi	NNP
Redmine	Redmine	NNP
RedMon	RedMon	NNP
reductio	reductio	FW
reentrancy	reentrancy	NN
reflog	reflog	NNP
RefluxJS	RefluxJS	NNP
Regasm	Regasm	NNP
regedit	regedit	NNP
RegIIS	RegIIS	NNP
Rekognition	Rekognition	NNP
relativelayouts	relativelayout	NNS
relativelayout	relativelayout	NN
ReLU	ReLU	NNP
RemarkJS	RemarkJS	NNP
RemoteApp	RemoteApp	NNP
RemoteIO	RemoteIO	NNP
Remoting	Remoting	NNP
Remotipart	Remotipart	NNP
Renjin	Renjin	NNP
ReplayKit	ReplayKit	NNP
ReplicaSet	ReplicaSet	NNP
ReportLab	ReportLab	NNP
ReQL	ReQL	NNP
RequireJS	RequireJS	NNP
Rerere	Rerere	NNP
resampling	resampling	NN
ResearchKit	ResearchKit	NNP
ReSharper	ReSharper	NNP
Resizer	Resizer	NNP
ResNet	ResNet	NNP
Resque	Resque	NNP
restartless	restartless	NNP
Restcomm	Restcomm	NNP
RESTEasy	RESTEasy	NNP
RestFB	RestFB	NNP
RESTHeart	RESTHeart	NNP
Restify	Restify	NNP
RestKit	RestKit	NNP
Restler	Restler	NNP
Restlet	Restlet	NNP
RESTPlus	RESTPlus	NNP
RestSharp	RestSharp	NNP
resty	resty	NNP
resx	resx	NNP
Rete	Rete	NNP
RethinkDB	RethinkDB	NNP
Reticulate	Reticulate	NNP
Retrolambda	Retrolambda	NNP
RETS	RETS	NNP
reversi	reversi	NNP
Revisionable	Revisionable	NNP
Revit	Revit	NNP
Revmob	Revmob	NNP
RExcel	RExcel	NNP
REXML	REXML	NNP
Rexster	Rexster	NNP
REXX	REXX	NNP
RFCOMM	RFCOMM	NNP
RFID	RFID	NNP
rgeo	rgeo	NNP
RGraph	RGraph	NNP
RhodeCode	RhodeCode	NNP
RhoMobile	RhoMobile	NNP
rhtml	rhtml	NNP
Rhythmbox	Rhythmbox	NNP
Riak	Riak	NNP
RibbonX	RibbonX	NNP
RichFaces	RichFaces	NNP
RichTextFX	RichTextFX	NNP
RightFax	RightFax	NNP
Rijndael	Rijndael	NNP
Rikulo	Rikulo	NNP
RingCentral	RingCentral	NNP
RInside	RInside	NNP
RinSim	RinSim	NNP
RISC	RISC	NNP
RJags	RJags	NNP
rJava	rJava	NNP
RJDBC	RJDBC	NNP
rjson	rjson	NNP
RJSONIO	RJSONIO	NNP
rlang	rlang	NNP
RMagick	RMagick	NNP
RMAN	RMAN	NNP
RMongo	RMongo	NNP
RMStore	RMStore	NNP
RMySQL	RMySQL	NNP
RNCryptor	RNCryptor	NNP
roadmaps	roadmap	NNS
roadmap	roadmap	NN
Robocode	Robocode	NNP
Robocopy	Robocopy	NNP
RoboGuice	RoboGuice	NNP
RoboHelp	RoboHelp	NNP
Robolectric	Robolectric	NNP
RoboSpice	RoboSpice	NNP
Robotium	Robotium	NNP
Robotlegs	Robotlegs	NNP
Roboto	Roboto	NNP
RoboVM	RoboVM	NNP
RocketMQ	RocketMQ	NNP
RocksDB	RocksDB	NNP
RODBC	RODBC	NNP
roguelike	roguelike	JJ
Roku	Roku	NNP
ROLAP	ROLAP	NNP
rolify	rolify	NNP
Rollbar	Rollbar	NNP
Rollout	Rollout	NNP
RollupJS	RollupJS	NNP
rootfs	rootfs	NNP
ropemacs	ropemacs	NNP
rOpenSci	rOpenSci	NNP
ROracle	ROracle	NNP
rospy	rospy	NNP
Rotativa	Rotativa	NNP
rotators	rotator	NNS
rotator	rotator	NN
ROWLEX	ROWLEX	NNP
roxygen	roxygen	NNP
RPGLE	RPGLE	NNP
rpmbuild	rpmbuild	NNP
RPres	RPres	NNP
Rprofile	Rprofile	NNP
RPXNow	RPXNow	NNP
RPyC	RPyC	NNP
RPython	RPython	NNP
RRDtool	RRDtool	NNP
rrule	rrule	NNP
Rscript	Rscript	NNP
RSelenium	RSelenium	NNP
Rserve	Rserve	NNP
RSpec	RSpec	NNP
RSQLite	RSQLite	NNP
RSSI	RSSI	NNP
RStan	RStan	NNP
RStudio	RStudio	NNP
rsvg	rsvg	NNP
Rsyslog	Rsyslog	NNP
RTEMS	RTEMS	NNP
RTMFP	RTMFP	NNP
RTMP	RTMP	NNP
Rtools	Rtools	NNP
RTOS	RTOS	NNP
RTSP	RTSP	NNP
rtweet	rtweet	NNP
ruamel	ruamel	NNP
Rubinius	Rubinius	NNP
RuboCop	RuboCop	NNP
Ruboto	Ruboto	NNP
Rubular	Rubular	NNP
RubyGems	RubyGems	NNP
RubyMotion	RubyMotion	NNP
rubyXL	rubyXL	NNP
Rubyzip	Rubyzip	NNP
runas	runas	NNP
Runbook	Runbook	NNP
Runge	Runge	NNP
Runit	Runit	NNP
runjags	runjags	NNP
RunKit	RunKit	NNP
runlevel	runlevel	NNP
RunOnce	RunOnce	NNP
rustdoc	rustdoc	NNP
Ruta	Ruta	NNP
rvest	rvest	NNP
rvmrc	rvmrc	NNP
RWeka	RWeka	NNP
rworldmap	rworldmap	NNP
RxCpp	RxCpp	NNP
RxDart	RxDart	NNP
RXTX	RXTX	NNP
rxvt	rxvt	NNP
Rythm	Rythm	NNP
SAAJ	SAAJ	NNP
SaaS	SaaS	NNP
SafetyNet	SafetyNet	NNP
SageMaker	SageMaker	NNP
Sahi	Sahi	NNP
Saiku	Saiku	NNP
Saleor	Saleor	NNP
Sametime	Sametime	NNP
Samsung	Samsung	NNP
Samtools	Samtools	NNP
Samza	Samza	NNP
Sankey	Sankey	NNP
SAPI	SAPI	NNP
SAPRFC	SAPRFC	NNP
SAPscript	SAPscript	NNP
Sarama	Sarama	NNP
Saripaar	Saripaar	NNP
SARSA	SARSA	NNP
SASL	SASL	NNP
SATA	SATA	NNP
Satchmo	Satchmo	NNP
satellizer	satellizer	NNP
Satis	Satis	NNP
satisfiability	satisfiability	NN
Savon	Savon	NNP
sbatch	sbatch	NNP
SBCL	SBCL	NNP
SBJson	SBJson	NNP
sbteclipse	sbteclipse	NNP
SCADA	SCADA	NNP
Scalac	Scalac	NNP
ScalaCheck	ScalaCheck	NNP
Scaladoc	Scaladoc	NNP
ScalaFX	ScalaFX	NNP
scalameta	scalameta	NNP
ScalaMock	ScalaMock	NNP
ScaLAPACK	ScaLAPACK	NNP
ScalaPB	ScalaPB	NNP
ScalaTags	ScalaTags	NNP
Scalate	Scalate	NNP
Scalatra	Scalatra	NNP
scalaxb	scalaxb	NNP
Scalaz	Scalaz	NNP
Scaldi	Scaldi	NNP
ScalikeJDBC	ScalikeJDBC	NNP
scancodes	scancode	NNS
scancode	scancode	NN
Scanline	Scanline	NNP
Scapy	Scapy	NNP
SceneKit	SceneKit	NNP
SchemaCrawler	SchemaCrawler	NNP
schemagen	schemagen	NNP
schemaless	schemaless	JJ
SchTasks	SchTasks	NNP
SciChart	SciChart	NNP
scikit	scikit	NNP
SciKits	SciKits	NNP
Scilab	Scilab	NNP
SCIM	SCIM	NNP
SCiO	SCiO	NNP
SCIP	SCIP	NNP
SciPy	SciPy	NNP
SciTE	SciTE	NNP
SCJP	SCJP	NNP
SCOM	SCOM	NNP
SCons	SCons	NNP
Scopus	Scopus	NNP
Scoreloop	Scoreloop	NNP
SCORM	SCORM	NNP
Scotty	Scotty	NNP
scoverage	scoverage	NNP
ScraperWiki	ScraperWiki	NNP
Scrapinghub	Scrapinghub	NNP
Scrapy	Scrapy	NNP
Scrapyd	Scrapyd	NNP
Screeps	Screeps	NNP
ScrewTurn	ScrewTurn	NNP
Scribd	Scribd	NNP
Scringo	Scringo	NNP
Scriplets	Scriplet	NNPS
Scriptaculous	Scriptaculous	NNP
Scriptblock	Scriptblock	NNP
scriptcs	scriptcs	NNP
Scriptella	Scriptella	NNP
Scriptler	Scriptler	NNP
Scrollify	Scrollify	NNP
ScrollMagic	ScrollMagic	NNP
Scrollspy	Scrollspy	NNP
SCSF	SCSF	NNP
SCXML	SCXML	NNP
SDCC	SDCC	NNP
SDKS	SDK	NNPS
SDKMAN	SDKMAN	NNP
SDLC	SDLC	NNP
Seaborn	Seaborn	NNP
searchbars	searchbar	NNS
searchbar	searchbar	NN
Searchkick	Searchkick	NNP
Searchkit	Searchkit	NNP
seccomp	seccomp	NNP
SecureSocial	SecureSocial	NNP
seekbars	seekbar	NNS
seekbar	seekbar	NN
SeeTest	SeeTest	NNP
selectivizr	selectivizr	NNP
Selectize	Selectize	NNP
SelectPdf	SelectPdf	NNP
Selendroid	Selendroid	NNP
Selenide	Selenide	NNP
Selenoid	Selenoid	NNP
SELinux	SELinux	NNP
Sencha	Sencha	NNP
SendBird	SendBird	NNP
SendGrid	SendGrid	NNP
SendinBlue	SendinBlue	NNP
sendmailR	sendmailR	NNP
SenseNet	SenseNet	NNP
Sensu	Sensu	NNP
SenTestingKit	SenTestingKit	NNP
senti	senti	FW
Sequelize	Sequelize	NNP
Serde	Serde	NNP
Serilog	Serilog	NNP
SERP	SERP	NNP
SERV	SERV	NNP
serverless	serverless	JJ
Serverspec	Serverspec	NNP
ServiceMix	ServiceMix	NNP
ServiceStack	ServiceStack	NNP
SevenZipSharp	SevenZipSharp	NNP
SFDC	SFDC	NNP
sfGuard	sfGuard	NNP
SFML	SFML	NNP
SGEN	SGEN	NNP
ShaderLab	ShaderLab	NNP
shapefiles	shapefile	NNS
shapefile	shapefile	NN
ShareKit	ShareKit	NNP
ShareThis	ShareThis	NNP
SharpDevelop	SharpDevelop	NNP
SharpDX	SharpDX	NNP
SharpGL	SharpGL	NNP
SharpMap	SharpMap	NNP
SharpPcap	SharpPcap	NNP
SharpSSH	SharpSSH	NNP
SharpSvn	SharpSvn	NNP
Shazam	Shazam	NNP
SheetJS	SheetJS	NNP
shellcode	shellcode	NN
Shellshock	Shellshock	NNP
shelveset	shelveset	NNP
SHFB	SHFB	NNP
shinyapps	shinyapps	NNP
shinyBS	shinyBS	NNP
shinyjs	shinyjs	NNP
ShinyProxy	ShinyProxy	NNP
Shippo	Shippo	NNP
Shiro	Shiro	NNP
Shockwave	Shockwave	NNP
Shopp	Shopp	NNP
Shopware	Shopware	NNP
shortcodes	shortcode	NNS
shortcode	shortcode	NN
Shortener	Shortener	NNP
Shoutcast	Shoutcast	NNP
ShoutEm	ShoutEm	NNP
shrinkwrap	shrinkwrap	NNP
shtml	shtml	NNP
shutil	shutil	NNP
SICP	SICP	NNP
SICStus	SICStus	NNP
Siddhi	Siddhi	NNP
Sidekiq	Sidekiq	NNP
sideloading	sideloading	NN
Sidr	Sidr	NNP
Siebel	Siebel	NNP
Siena	Siena	NNP
sIFR	sIFR	NNP
Sigar	Sigar	NNP
SignalR	SignalR	NNP
signedness	signedness	NN
Sikuli	Sikuli	NNP
Silex	Silex	NNP
SilkTest	SilkTest	NNP
Silverlight	Silverlight	NNP
SilverStripe	SilverStripe	NNP
SIMBL	SIMBL	NNP
SIMD	SIMD	NNP
SimGrid	SimGrid	NNP
Simperium	Simperium	NNP
Simphony	Simphony	NNP
SimpleCart	SimpleCart	NNP
SimpleCov	SimpleCov	NNP
SimpleCV	SimpleCV	NNP
SimpleDB	SimpleDB	NNP
SimpleITK	SimpleITK	NNP
SimplePie	SimplePie	NNP
SimpleXML	SimpleXML	NNP
Simpsons	Simpson	NNPS
SimPy	SimPy	NNP
Simscape	Simscape	NNP
Simulink	Simulink	NNP
Sinch	Sinch	NNP
singularitygs	singularitygs	NNP
Sinopia	Sinopia	NNP
SIPml	SIPml	NNP
Sitebricks	Sitebricks	NNP
Sitecore	Sitecore	NNP
Sitefinity	Sitefinity	NNP
SiteMesh	SiteMesh	NNP
SiteMinder	SiteMinder	NNP
SJCL	SJCL	NNP
sjPlot	sjPlot	NNP
skbio	skbio	NNP
SketchFlow	SketchFlow	NNP
SketchUp	SketchUp	NNP
skflow	skflow	NNP
Skia	Skia	NNP
SkiaSharp	SkiaSharp	NNP
sklearn	sklearn	NNP
SKMaps	SKMaps	NNP
skobbler	skobbler	NNP
SKOS	SKOS	NNP
skrollr	skrollr	NNP
Skulpt	Skulpt	NNP
Skybox	Skybox	NNP
SkyDNS	SkyDNS	NNP
Skyfield	Skyfield	NNP
Slackware	Slackware	NNP
SlamData	SlamData	NNP
SlateJS	SlateJS	NNP
SLES	SLES	NNP
SlickEdit	SlickEdit	NNP
SlickGrid	SlickGrid	NNP
SlickNav	SlickNav	NNP
SlidesJS	SlidesJS	NNP
Slidify	Slidify	NNP
SlimBox	SlimBox	NNP
SlimDX	SlimDX	NNP
SlimerJS	SlimerJS	NNP
Slony	Slony	NNP
SlowCheetah	SlowCheetah	NNP
Slurm	Slurm	NNP
Smali	Smali	NNP
SmartAdmin	SmartAdmin	NNP
SmartBanner	SmartBanner	NNP
SmartEyeglass	SmartEyeglass	NNP
Smartface	Smartface	NNP
SmartGit	SmartGit	NNP
SmartScreen	SmartScreen	NNP
Smartsheet	Smartsheet	NNP
SmartSVN	SmartSVN	NNP
SmartThings	SmartThings	NNP
SmartyStreets	SmartyStreets	NNP
SMBus	SMBus	NNP
SMIL	SMIL	NNP
Smooks	Smooks	NNP
SmoothState	SmoothState	NNP
SMPP	SMPP	NNP
SMTP	SMTP	NNP
Snakemake	Snakemake	NNP
SnakeYAML	SnakeYAML	NNP
Snapchat	Snapchat	NNP
Snapcraft	Snapcraft	NNP
SnapKit	SnapKit	NNP
SnappyData	SnappyData	NNP
snipMate	snipMate	NNP
snmpd	snmpd	NNP
snmptrapd	snmptrapd	NNP
SOAPLite	SOAPLite	NNP
SOAPpy	SOAPpy	NNP
SoapUI	SoapUI	NNP
Sobel	Sobel	NNP
socat	socat	NNP
SOCI	SOCI	NNP
SocialShare	SocialShare	NNP
SocketCluster	SocketCluster	NNP
SocketRocket	SocketRocket	NNP
SocketScan	SocketScan	NNP
SocketServer	SocketServer	NNP
SockJs	SockJs	NNP
Socrata	Socrata	NNP
SoftHSM	SoftHSM	NNP
softmax	softmax	NNP
Solandra	Solandra	NNP
Solaris	Solaris	NNP
SolrCloud	SolrCloud	NNP
SolrJ	SolrJ	NNP
SolrNet	SolrNet	NNP
SonarCloud	SonarCloud	NNP
SonarJS	SonarJS	NNP
SonarLint	SonarLint	NNP
SonarQube	SonarQube	NNP
Sonatype	Sonatype	NNP
Soomla	Soomla	NNP
SOQL	SOQL	NNP
SortableJS	SortableJS	NNP
sortedlists	sortedlist	NNS
sortedlist	sortedlist	NN
sortedmaps	sortedmap	NNS
sortedmap	sortedmap	NN
sortedsets	sortedset	NNS
sortedset	sortedset	NN
Sosex	Sosex	NNP
Soundex	Soundex	NNP
SoundFont	SoundFont	NNP
SoundJS	SoundJS	NNP
SoundTouch	SoundTouch	NNP
SourceGear	SourceGear	NNP
SourceSafe	SourceSafe	NNP
sourcetrees	sourcetree	NN
sourcetree	sourcetree	NN
Spacebars	Spacebars	NNP
Spacemacs	Spacemacs	NNP
spaCy	spaCy	NNP
SpagoBI	SpagoBI	NNP
SpamAssassin	SpamAssassin	NNP
SPARC	SPARC	NNP
sparklines	sparkline	NNS
sparkline	sparkline	NN
sparklyr	sparklyr	NNP
SparkPost	SparkPost	NNP
SparkR	SparkR	NNP
Spatie	Spatie	NNP
spatstat	spatstat	NNP
spdep	spdep	NNP
SPDY	SPDY	NNP
SpecFlow	SpecFlow	NNP
Specman	Specman	NNP
SpecRun	SpecRun	NNP
Spectron	Spectron	NNP
Speex	Speex	NNP
Spek	Spek	NNP
SPFx	SPFx	NNP
Sphero	Sphero	NNP
SphinxQL	SphinxQL	NNP
Spiceworks	Spiceworks	NNP
SpiderMonkey	SpiderMonkey	NNP
SPIR	SPIR	NNP
splitviews	splitview	NNS
splitview	splitview	NN
Splunk	Splunk	NNP
SPMD	SPMD	NNP
SPNEGO	SPNEGO	NNP
SpookyJS	SpookyJS	NNP
spoolers	spooler	NNS
spooler	spooler	NN
spork	spork	NNP
SpotBugs	SpotBugs	NNP
Spotfire	Spotfire	NNP
Spotipy	Spotipy	NNP
Sprache	Sprache	NNP
SpreadsheetGear	SpreadsheetGear	NNP
SpringFox	SpringFox	NNP
SpringSource	SpringSource	NNP
SpriteBatch	SpriteBatch	NNP
Spritefont	Spritefont	NNP
SproutCore	SproutCore	NNP
SPServices	SPServices	NNP
SPSS	SPSS	NNP
Spyder	Spyder	NNP
spymemcached	spymemcached	NNP
Spyne	Spyne	NNP
Spynner	Spynner	NNP
sqflite	sqflite	NNP
SQLAlchemy	SQLAlchemy	NNP
SQLBase	SQLBase	NNP
SQLBrite	SQLBrite	NNP
SqlBuilder	SqlBuilder	NNP
SQLCipher	SQLCipher	NNP
sqlcmd	sqlcmd	NNP
SQLDW	SQLDW	NNP
SQLJ	SQLJ	NNP
sqlmap	sqlmap	NNP
SQLMetal	SQLMetal	NNP
sqlproj	sqlproj	NNP
sqlps	sqlps	NNP
SQLX	SQLX	NNP
SQLyog	SQLyog	NNP
Sqoop	Sqoop	NNP
sqrt	sqrt	NN
sqsh	sqsh	NNP
Squashfs	Squashfs	NNP
Squeel	Squeel	NNP
Squeryl	Squeryl	NNP
SquirrelMail	SquirrelMail	NNP
SquishIt	SquishIt	NNP
SSAO	SSAO	NNP
SSAS	SSAS	NNP
SSDP	SSDP	NNP
SSDT	SSDT	NNP
SSHD	SSHD	NNP
SSHFS	SSHFS	NNP
sshj	sshj	NNP
SSHKit	SSHKit	NNP
sshpass	sshpass	NNP
SSID	SSID	NNP
SSIM	SSIM	NNP
SSIS	SSIS	NNP
SSJS	SSJS	NNP
SSML	SSML	NNP
SSMS	SSMS	NNP
SSMTP	SSMTP	NNP
SSReflect	SSReflect	NNP
SSRS	SSRS	NNP
SSSD	SSSD	NNP
Stackage	Stackage	NNP
StackBlitz	StackBlitz	NNP
Stackless	Stackless	NNP
StackMob	StackMob	NNP
Stagefright	Stagefright	NNP
Stanbol	Stanbol	NNP
StarCluster	StarCluster	NNP
Stardog	Stardog	NNP
Stargate	Stargate	NNP
Starscream	Starscream	NNP
StartApp	StartApp	NNP
StarTeam	StarTeam	NNP
STARTTLS	STARTTLS	NNP
StarUML	StarUML	NNP
Stata	Stata	NNP
Statechart	Statechart	NNP
Stateflow	Stateflow	NNP
statnet	statnet	NNP
StatsD	StatsD	NNP
Stax	Stax	NNP
stdafx	stdafx	NNP
SteamBot	SteamBot	NNP
SteamVR	SteamVR	NNP
Steamworks	Steamworks	NNP
steganography	steganography	NN
StencilJS	StencilJS	NNP
Stetho	Stetho	NNP
stickit	stickit	NNP
Stimulsoft	Stimulsoft	NNP
STLport	STLport	NNP
StockTwits	StockTwits	NNP
StoreKit	StoreKit	NNP
StormCrawler	StormCrawler	NNP
Stormpath	Stormpath	NNP
strace	strace	NNP
Strapi	Strapi	NNP
Strassen	Strassen	NNP
Stratio	Stratio	NNP
Strava	Strava	NNP
stringdist	stringdist	NNP
stringification	stringification	NN
StringIO	StringIO	NNP
stringr	stringr	NNP
StrongLoop	StrongLoop	NNP
Structr	Structr	NNP
stsadm	stsadm	NNP
stty	stty	NNP
stunnel	stunnel	NNP
STXXL	STXXL	NNP
StyleCop	StyleCop	NNP
Styleguidist	Styleguidist	NNP
Subclipse	Subclipse	NNP
Subform	Subform	NNP
SubGit	SubGit	NNP
Subgraph	Subgraph	NNP
Subgrid	Subgrid	NNP
Subgurim	Subgurim	NNP
SublimeLinter	SublimeLinter	NNP
SubProject	SubProject	NNP
Subresource	Subresource	NNP
subsampling	subsampling	NN
subshells	subshell	NNS
subshell	subshell	NN
subtyping	subtyping	NN
Suckerfish	Suckerfish	NNP
sudoers	sudoers	NNP
sudoku	sudoku	NNP
SudzC	SudzC	NNP
SuExec	SuExec	NNP
SugarCRM	SugarCRM	NNP
Suhosin	Suhosin	NNP
SUID	SUID	NNP
SuiteCRM	SuiteCRM	NNP
SuiteScript	SuiteScript	NNP
SuiteTalk	SuiteTalk	NNP
Sulu	Sulu	NNP
summarization	summarization	NN
Summernote	Summernote	NNP
SunOS	SunOS	NNP
SuperAgent	SuperAgent	NNP
Superfish	Superfish	NNP
SuperTest	SuperTest	NNP
Supervisord	Supervisord	NNP
suPHP	suPHP	NNP
SurfaceFlinger	SurfaceFlinger	NNP
Suricata	Suricata	NNP
SurveyJS	SurveyJS	NNP
SurveyMonkey	SurveyMonkey	NNP
SUSE	SUSE	NNP
Sustainsys	Sustainsys	NNP
Svcutil	Svcutil	NNP
SVGKit	SVGKit	NNP
SVMLight	SVMLight	NNP
svnadmin	svnadmin	NNP
SvnAnt	SvnAnt	NNP
SVNKit	SVNKit	NNP
svnserve	svnserve	NNP
svnsync	svnsync	NNP
swapfile	swapfile	NNP
Sweave	Sweave	NNP
SweetAlert	SweetAlert	NNP
Swiffy	Swiffy	NNP
SwiftCharts	SwiftCharts	NNP
SwiftLint	SwiftLint	NNP
SwiftSoup	SwiftSoup	NNP
SwiftUI	SwiftUI	NNP
Swifty	Swifty	NNP
SwiftyDropbox	SwiftyDropbox	NNP
SwingX	SwingX	NNP
Swinject	Swinject	NNP
Swiper	Swiper	NNP
SwitchYard	SwitchYard	NNP
SWRL	SWRL	NNP
SWTBot	SWTBot	NNP
SWXMLHash	SWXMLHash	NNP
Sylius	Sylius	NNP
Symfony	Symfony	NNP
SymmetricDS	SymmetricDS	NNP
SymPy	SymPy	NNP
Syncfusion	Syncfusion	NNP
SyncML	SyncML	NNP
Syncsort	Syncsort	NNP
SynEdit	SynEdit	NNP
Synology	Synology	NNP
Synopsys	Synopsys	NNP
Syntastic	Syntastic	NNP
SyntaxNet	SyntaxNet	NNP
sysctl	sysctl	NNP
SYSDBA	SYSDBA	NNP
sysfs	sysfs	NNP
SysML	SysML	NNP
Sysprep	Sysprep	NNP
SystemC	SystemC	NNP
systemctl	systemctl	NNP
systemd	systemd	NNP
SystemJS	SystemJS	NNP
SystemTap	SystemTap	NNP
Systrace	Systrace	NNP
systray	systray	NNP
SysV	SysV	NNP
tablelayouts	tablelayout	NNS
tablelayout	tablelayout	NN
TableTools	TableTools	NNP
tableviews	tableview	NNS
tableview	tableview	NN
Tabris	Tabris	NNP
Tabu	Tabu	NNP
Tabula	Tabula	NNP
tabviews	tabview	NNS
tabview	tabview	NN
taction	taction	NN
TaffyDB	TaffyDB	NNP
taggable	taggable	JJ
taggit	taggit	NNP
Talend	Talend	NNP
Taleo	Taleo	NNP
TalkBack	TalkBack	NNP
Tampermonkey	Tampermonkey	NNP
TAPI	TAPI	NNP
Tapjoy	Tapjoy	NNP
tapku	tapku	NNP
Tarantool	Tarantool	NNP
TarsosDSP	TarsosDSP	NNP
Taskdef	Taskdef	NNP
Tasker	Tasker	NNP
tasklet	tasklet	NNP
TASM	TASM	NNP
Tastypie	Tastypie	NNP
TBXML	TBXML	NNP
tclsh	tclsh	NNP
TCMS	TCMS	NNP
tcomb	tcomb	NNP
TCPDF	TCPDF	NNP
tcpdump	tcpdump	NNP
tcpreplay	tcpreplay	NNP
tcpserver	tcpserver	NNP
tcsh	tcsh	NNP
Tealium	Tealium	NNP
TeamSite	TeamSite	NNP
TeamSpeak	TeamSpeak	NNP
TeeChart	TeeChart	NNP
Teensy	Teensy	NNP
Tegra	Tegra	NNP
Teiid	Teiid	NNP
Telegraf	Telegraf	NNP
Telepot	Telepot	NNP
Telerik	Telerik	NNP
Temboo	Temboo	NNP
tempdb	tempdb	NNP
TemplaVoila	TemplaVoila	NNP
TEMPUS	TEMPUS	NNP
Tendermint	Tendermint	NNP
TensorBoard	TensorBoard	NNP
TensorRT	TensorRT	NNP
Teradata	Teradata	NNP
TeraTerm	TeraTerm	NNP
termcap	termcap	NNP
terminfo	terminfo	NNP
Termux	Termux	NNP
tesselation	tesselation	NN
TestCafe	TestCafe	NNP
TestDriven	TestDriven	NNP
Testem	Testem	NNP
TestFairy	TestFairy	NNP
TestFX	TestFX	NNP
TestKit	TestKit	NNP
Testnet	Testnet	NNP
TestNG	TestNG	NNP
TestRail	TestRail	NNP
TestStack	TestStack	NNP
Tetris	Tetris	NNP
Texmaker	Texmaker	NNP
TextBlob	TextBlob	NNP
TextCtrl	TextCtrl	NNP
TextEdit	TextEdit	NNP
TexText	TexText	NNP
TextKit	TextKit	NNP
TextMate	TextMate	NNP
TextPad	TextPad	NNP
TextWrangler	TextWrangler	NNP
TFLearn	TFLearn	NNP
TFrame	TFrame	NNP
tfrecord	tfrecord	NNP
TFSBuild	TFSBuild	NNP
TFTP	TFTP	NNP
TFVC	TFVC	NNP
Theano	Theano	NNP
TheMovieDB	TheMovieDB	NNP
Theora	Theora	NNP
THEOS	THEOS	NNP
therubyracer	therubyracer	NNP
ThickBox	ThickBox	NNP
ThingWorx	ThingWorx	NNP
Thinktecture	Thinktecture	NNP
Thorntail	Thorntail	NNP
ThoughtWorks	ThoughtWorks	NNP
ThreeCSG	ThreeCSG	NNP
threetenbp	threetenbp	NNP
thresholding	thresholding	NN
Thunderbird	Thunderbird	NNP
tibbles	tibble	NNPS
tibble	tibble	NNP
TIBCO	TIBCO	NNP
TiDB	TiDB	NNP
TiddlyWiki	TiddlyWiki	NNP
TideSDK	TideSDK	NNP
tidygraph	tidygraph	NNP
tidyquant	tidyquant	NNP
tidyr	tidyr	NNP
tidytext	tidytext	NNP
tidyverse	tidyverse	NNP
Tigase	Tigase	NNP
Tika	Tika	NNP
Tiki	Tiki	NNP
TikZ	TikZ	NNP
TileMill	TileMill	NNP
Timage	Timage	NNP
timecodes	timecode	NNS
timelapses	timelapse	NNS
timelapse	timelapse	NN
timelion	Timelion	NNP
timepickers	timepicker	NNS
timepicker	timepicker	NN
TimescaleDB	TimescaleDB	NNP
timeslot	timeslot	NN
timeslots	timeslot	NNS
timeunits	timeunit	NNS
timeunit	timeunit	NN
TinkerPop	TinkerPop	NNP
tintColor	tintColor	NNP
TinyDB	TinyDB	NNP
TinyIoC	TinyIoC	NNP
TinyOS	TinyOS	NNP
TinyURL	TinyURL	NNP
TinyXml	TinyXml	NNP
Tipfy	Tipfy	NNP
tippyjs	tippyjs	NNP
Tizen	Tizen	NNP
TLA+	TLA+	NNP
TMemo	TMemo	NNP
Tmpfs	Tmpfs	NNP
Tmux	Tmux	NNP
tmuxinator	tmuxinator	NNP
Togglz	Togglz	NNP
TokuDB	TokuDB	NNP
TokuMX	TokuMX	NNP
tombstoning	tombstoning	NN
TomEE	TomEE	NNP
TomTom	TomTom	NNP
Tooltipster	Tooltipster	NNP
Tooltwist	Tooltwist	NNP
TopBraid	TopBraid	NNP
topdown	topdown	JJ
topojson	topojson	NNP
Topshelf	Topshelf	NNP
torchtext	torchtext	NNP
torchvision	torchvision	NNP
tornadofx	tornadofx	NNP
TorqueBox	TorqueBox	NNP
TortoiseCVS	TortoiseCVS	NNP
TortoiseGit	TortoiseGit	NNP
TortoiseHg	TortoiseHg	NNP
TortoiseSVN	TortoiseSVN	NNP
TOTP	TOTP	NNP
TouchDB	TouchDB	NNP
touchpads	touchpad	NNS
touchpad	touchpad	NN
towerjs	towerjs	NNP
Trac	Trac	NNP
traceroute	traceroute	NN
Traceur	Traceur	NNP
trackbars	trackbar	NNS
trackbar	trackbar	NN
trackpads	trackpad	NNS
trackpad	trackpad	NN
tradeoffs	tradeoff	NNS
tradeoff	tradeoff	NN
TraitsUI	TraitsUI	NNP
transclusions	transclusion	NNS
transclusion	transclusion	NN
TransCrypt	TransCrypt	NNP
Transloadit	Transloadit	NNP
traversable	traversable	JJ
trialwares	trialware	NNS
trialware	trialware	NN
Tridion	Tridion	NNP
trilaterations	trilateration	NNS
trilateration	trilateration	NN
TripleDES	TripleDES	NNP
Triplestore	Triplestore	NNP
Tropo	Tropo	NNP
TruClient	TruClient	NNP
TrueCrypt	TrueCrypt	NNP
TrueSTUDIO	TrueSTUDIO	NNP
Trumbowyg	Trumbowyg	NNP
Tryton	Tryton	NNP
tshark	tshark	NNP
tsify	tsify	NNP
tsqlt	tSQLt	NNP
Tsung	Tsung	NNP
TTML	TTML	NNP
TuesPechkin	TuesPechkin	NNP
Tufte	Tufte	NNP
Tukey	Tukey	NNP
Tuleap	Tuleap	NN
Turfjs	Turfjs	NNP
TVJS	TVJS	NNP
TVML	TVML	NNP
tvOS	tvOS	NNP
tweenjs	TweenJS	NNP
TweenLite	TweenLite	NNP
TweenMax	TweenMax	NNP
Tweepy	Tweepy	NNP
Tweetinvi	Tweetinvi	NNP
twemproxy	twemproxy	NNP
TWIKI	TWIKI	NNP
TwiML	TwiML	NNP
TwinCAT	TwinCAT	NNP
Twitpic	Twitpic	NNP
Twitterizer	Twitterizer	NNP
TypeDoc	TypeDoc	NNP
Typeform	Typeform	NNP
typehead	typehead	NNP
typehint	typehint	NN
typehints	typehint	NNS
Typekit	Typekit	NNP
TypeLITE	TypeLITE	NNP
Typemock	Typemock	NNP
TypeORM	TypeORM	NNP
typeprovider	typeprovider	NN
typeproviders	typeprovider	NNS
typesafe	typesafe	JJ
typetrait	typetrait	NN
typetraits	typetrait	NNS
UART	UART	NNP
Uber	Uber	NNP
Ubercart	Ubercart	NNP
uberjar	uberjar	NN
UBIFS	UBIFS	NNP
uBLAS	uBLAS	NNP
UDDI	UDDI	NNP
udev	udev	NN
uglifier	uglifier	NNP
uglifyjs	uglifyjs	NNP
UIMA	UIMA	NNP
UINib	UINib	NNP
UIStepper	UIStepper	NNP
UITest	UITest	NNP
UltiSnips	UltiSnips	NNP
UltraEdit	UltraEdit	NNP
Umbraco	Umbraco	NNP
UMFPACK	UMFPACK	NNP
umount	umount	NN
UMTS	UMTS	NNP
uname	uname	NN
UnCSS	UnCSS	NNP
UnetStack	UnetStack	NNP
Unfuddle	Unfuddle	NNP
UniDAC	UniDAC	NNP
Unirest	Unirest	NNP
unistd	unistd	NNP
Unitils	Unitils	NNP
UnityScript	UnityScript	NNP
uniVocity	uniVocity	NNP
unixODBC	unixODBC	NNP
unmanaged	unmanaged	JJ
unmarshall	unmarshall	VB
unmarshalled	unmarshall	VBD
unmarshalling	unmarshall	VBG
unoconv	unoconv	NNP
UnRAR	UnRAR	NNP
UnrealScript	UnrealScript	NNP
unshelved	unshelve	VBD
unshelving	unshelve	VBG
unshelve	unshelve	VB
Unslider	Unslider	NNP
upcasted	upcast	VBD
upcast	upcast	VB
upcasting	upcast	VBG
upcasting	upcasting	NN
uPickle	uPickle	NNP
UploadiFive	UploadiFive	NNP
Uploadify	Uploadify	NNP
UPnP	UPnP	NNP
Uppaal	Uppaal	NNP
upperbounds	upperbound	NNS
upperbound	upperbound	NN
UPSERT	UPSERT	NNP
urlencoding	urlencoding	NN
usertype	usertype	NN
usleep	usleep	NN
usort	usort	NN
USSD	USSD	NNP
utop	utop	NN
uTorrent	uTorrent	NNP
Uuencode	Uuencode	NNP
UwAmp	UwAmp	NNP
uWSGI	uWSGI	NNP
Vaadin	Vaadin	NNP
Vagrantfile	Vagrantfile	NNP
Vala	Vala	NNP
valign	valign	NN
Vavr	Vavr	NNP
vbox	vbox	NN
vBulletin	vBulletin	NNP
vCard	vCard	NNP
vCenter	vCenter	NNP
vCloud	vCloud	NNP
vcpkg	vcpkg	NN
vcproj	vcproj	NN
vcxproj	vcxproj	NN
vdproj	vdproj	NN
vDSP	vDSP	NNP
venvs	venv	NNS
venv	venv	NN
Veracode	Veracode	NNP
VeriFone	VeriFone	NNP
Verilog	Verilog	NNP
Verisign	Verisign	NNP
VersionOne	VersionOne	NNP
Vertica	Vertica	NNP
Vespa	Vespa	NNP
VHDL	VHDL	NNP
vhost	vhost	NN
vhosts	vhost	NNS
Viber	Viber	NNP
videochats	videochat	NNS
videochat	videochat	NN
VirtualBox	VirtualBox	NNP
virtualhosts	virtualhost	NNS
virtualhost	virtualhost	NN
Visio	Visio	NNP
VisPy	VisPy	NNP
Vitamio	Vitamio	NNP
Viterbi	Viterbi	NNP
Vivado	Vivado	NNP
VIVE	VIVE	NNP
VLAN	VLAN	NNP
VNeT	VNeT	NNP
vNext	vNext	NNP
voiceover	voiceover	NN
VoiceXML	VoiceXML	NNP
VOIP	VOIP	NNP
Voldemort	Voldemort	NNP
VoltDB	VoltDB	NNP
voltrb	voltrb	NNP
volttron	volttron	NN
Volusion	Volusion	NNP
vorpal	vorpal	JJ
votable	votable	JJ
VPython	VPython	NNP
vQmod	vQmod	NNP
vSphere	vSphere	NNP
vsync	vsync	NN
vtables	vtable	NNS
vtable	vtable	NN
Vtiger	Vtiger	NNP
VTune	VTune	NNP
Vuefire	Vuefire	NNP
Vuelidate	Vuelidate	NNP
VuePress	VuePress	NNP
Vuex	Vuex	NNP
Vuforia	Vuforia	NNP
VuGen	VuGen	NNP
Vulkan	Vulkan	NNP
Vundle	Vundle	NNP
Vungle	Vungle	NNP
VXML	VXML	NNP
VxWorks	VxWorks	NNP
Wacom	Wacom	NNP
WADL	WADL	NNP
waitpid	waitpid	NNP
Wakanda	Wakanda	NNP
Wakelock	Wakelock	NNP
WAMP	WAMP	NNP
WARC	WARC	NNP
Warshall	Warshall	NNP
WASAPI	WASAPI	NNP
WatchFace	WatchFace	NNP
watchify	watchify	NNP
WatchKit	WatchKit	NNP
watchpoints	watchpoint	NNS
watchpoint	watchpoint	NN
WATIR	WATIR	NNP
Wavemaker	Wavemaker	NNP
waveout	waveout	NN
wavesurfer	wavesurfer	NNP
WBEM	WBEM	NNP
WCAG	WCAG	NNP
WCSF	WCSF	NNP
wearable	wearable	NN
wearables	wearable	NNS
webapis	webapi	NNS
webapi	webapi	NN
webapp	webapp	NN
webapps	webapp	NNS
WebAssembly	WebAssembly	NNP
webasset	webasset	NN
webassets	webassets	NNS
WebAuthn	WebAuthn	NNP
webclients	webclient	NNS
webclient	webclient	NN
WebDAV	WebDAV	NNP
webdevs	webdev	NNS
webdev	webdev	NN
WebEngine	WebEngine	NNP
webm	webm	NNP
webmachine	webmachine	NNP
webp	webp	NNP
WebSphere	WebSphere	NNP
WebStorm	WebStorm	NNP
Weebly	Weebly	NN
WEEX	WEEX	NNP
weinre	weinre	NNP
Weka	Weka	NNP
Wercker	Wercker	NNP
werkzeug	werkzeug	NNP
wget	wget	NNP
WhatsAPI	WhatsAPI	NNP
WhatsApp	WhatsApp	NNP
wheelnav	wheelnav	NNP
whiptail	whiptail	NNP
WHMCS	WHMCS	NNP
Whois	Whois	NNP
Wicketstuff	Wicketstuff	NNP
Widevine	Widevine	NNP
Wiimote	Wiimote	NNP
wijmo	wijmo	NNP
Wikitext	Wikitext	NNP
Wikitude	Wikitude	NNP
Winamp	Winamp	NNP
WIQL	WIQL	NNP
WireMock	Wire	NNP
WireCloud	WireCloud	NNP
wiredep	wiredep	NNP
WiredTiger	WiredTiger	NNP
Wireshark	Wireshark	NNP
WiringPi	WiringPi	NNP
Wistia	Wistia	NNP
wixsharp	wixsharp	NNP
wkhtmltopdf	wkhtmltopdf	NNP
WLAN	WLAN	NNP
WLST	WLST	NNP
WMIC	WMIC	NNP
woff	woff	NNP
wofstream	wofstream	NNP
WolframAlpha	WolframAlpha	NNP
wolfSSL	wolfSSL	NNP
wolkenkit	wolkenkit	NNP
Wonderware	Wonderware	NNP
woodstox	woodstox	NNP
WOPI	WOPI	NNP
WordML	WordML	NNP
WordNet	WordNet	NNP
WordPad	WordPad	NNP
Workbox	Workbox	NNP
Workfront	Workfront	NNP
WorkFusion	WorkFusion	NNP
worklights	worklight	NNS
worklight	worklight	NN
worktrees	worktree	NNS
worktree	worktree	NN
Worldpay	Worldpay	NNP
WorldWind	WorldWind	NNP
Wowza	Wowza	NNP
WPBakery	WPBakery	NNP
WPML	WPML	NNP
WPMU	WPMU	NNP
WPToolkit	WPToolkit	NNP
wsadmin	wsadmin	NNP
wsgen	wsgen	NNP
wsimport	wsimport	NNP
WSIT	WSIT	NNP
WSMan	WSMan	NNP
WSOD	WSOD	NNP
WSSE	WSSE	NNP
WTForms	WTForms	NNP
Wufoo	Wufoo	NNP
WURFL	WURFL	NNP
WWDC	WWDC	NNP
WYMeditor	WYMeditor	NNP
XACML	XACML	NNP
xajax	xajax	NNP
Xalan	Xalan	NNP
Xamarin	Xamarin	NNP
XAML	XAML	NNP
XAMPP	XAMPP	NNP
Xapian	Xapian	NNP
xargs	xargs	NNP
xaringan	xaringan	NNP
XBAP	XBAP	NNP
xBase	xBase	NNP
XBee	XBee	NNP
xBind	xBind	NNP
XBMC	XBMC	NNP
Xbox	Xbox	NNP
xbrl	xbrl	NN
xbuild	xbuild	NNP
xclip	xclip	NNP
xcodebuild	xcodebuild	NNP
Xdebug	Xdebug	NNP
xdist	xdist	NNP
XDoclet	XDoclet	NNP
xdotool	xdotool	NNP
xelatex	xelatex	NNP
XenApp	XenApp	NNP
XenForo	XenForo	NNP
Xenomai	Xenomai	NNP
Xeon	Xeon	NNP
Xerces	Xerces	NNP
Xero	Xero	NNP
XFBML	XFBML	NN
Xfce	Xfce	NNP
xfdf	xfdf	NN
Xfire	Xfire	NNP
XForms	XForms	NNP
XGBoost	XGBoost	NNP
Xhprof	Xhprof	NNP
Xiaomi	Xiaomi	NNP
Xidel	Xidel	NNP
Xilinx	Xilinx	NNP
XInclude	XInclude	NNP
xinetd	xinetd	NNP
Xively	Xively	NNP
XLabs	XLabs	NNP
XLConnect	XLConnect	NNP
XLForm	XLForm	NNP
xlrd	xlrd	NNP
xlsb	xlsb	NN
xlsm	xlsm	NN
xlsread	xlsread	NNP
xlsx	xlsx	NNP
xlutils	xlutils	NNP
xlwings	xlwings	NNP
xlwt	xlwt	NNP
Xmgrace	Xmgrace	NNP
Xming	Xming	NNP
XMLA	XMLA	NNP
XMODEM	XMODEM	NNP
xmodmap	xmodmap	NNP
xmonad	xmonad	NNP
XMPP	XMPP	NNP
XMPPHP	XMPPHP	NNP
xmpppy	xmpppy	NNP
Xodus	Xodus	NNP
Xojo	Xojo	NN
Xoom	Xoom	NNP
XOrg	XOrg	NNP
XPages	XPages	NNP
XPCE	XPCE	NNP
XPCOM	XPCOM	NNP
Xpdf	Xpdf	NNP
Xperf	Xperf	NNP
XPERIA	XPERIA	NNP
XPiNC	XPiNC	NNP
Xposed	Xposed	NNP
XProc	XProc	NNP
XQuartz	XQuartz	NNP
xrandr	xrandr	NNP
xrays	xray	NNS
xray	xray	NN
XServer	XServer	NNP
xsom	xsom	NNP
XSSF	XSSF	NNP
Xtend	Xtend	NNP
xtermjs	xtermjs	NNP
Xtext	Xtext	NNP
Xtify	Xtify	NNP
Xtion	Xtion	NNP
XtraDB	XtraDB	NNP
Xubuntu	Xubuntu	NNP
Xuggle	Xuggle	NNP
Xuggler	Xuggler	NNP
XULRunner	XULRunner	NNP
xUnit	xUnit	NNP
xvalue	xvalue	NN
Xvfb	Xvfb	NNP
XWiki	XWiki	NNP
XWPF	XWPF	NNP
yadcf	yadcf	NNP
YAJL	YAJL	NNP
yajra	yajra	NNP
YAJSW	YAJSW	NNP
YamlDotNet	YamlDotNet	NNP
Yandex	Yandex	NNP
yargs	yargs	NNP
yarn	yarn	NNP
yarnpkg	yarnpkg	NN
Yasm	Yasm	NNP
yasnippet	yasnippet	NNP
yAxis	yAxis	NNP
YCSB	YCSB	NNP
yepnope	yepnope	NNP
Yesod	Yesod	NNP
Yoast	Yoast	NNP
Yodlee	Yodlee	NNP
YOLO	YOLO	NN
Yosys	Yosys	NN
YourKit	YourKit	NNP
YOURLS	YOURLS	NN
YouTrack	YouTrack	NNP
YSlow	YSlow	NNP
Yubico	Yubico	NNP
YUIDoc	YUIDoc	NNP
Zabbix	Zabbix	NNP
zalenium	zalenium	NNP
ZBar	ZBar	NNP
zcat	zcat	NNP
zclip	zclip	NNP
Zebble	Zebble	NNP
ZedGraph	ZedGraph	NNP
Zeep	Zeep	NNP
ZEIT	ZEIT	NNP
Zelle	Zelle	NNP
ZenDesk	ZenDesk	NNP
ZendX	ZendX	NNP
Zenity	Zenity	NNP
Zenject	Zenject	NNP
Zenoss	Zenoss	NNP
zentest	zentest	NNP
ZeroBrane	ZeroBrane	NNP
Zeroconf	Zeroconf	NNP
ZeroMQ	ZeroMQ	NNP
zerorpc	zerorpc	NNP
ZfcUser	ZfcUser	NNP
Zilla	Zilla	NNP
Zimbra	Zimbra	NNP
ZingChart	ZingChart	NNP
zipalign	zipalign	NNP
ziparchives	ziparchive	NNS
ziparchive	ziparchive	NN
zipcodes	zipcode	NNS
zipcode	zipcode	NN
Zipkin	Zipkin	NNP
ziplines	zipline	NNS
zipline	zipline	NN
ZKTeco	ZKTeco	NNP
ZODB	ZODB	NNP
Zomato	Zomato	NNP
zonejs	zonejs	NN
ZoomCharts	ZoomCharts	NNP
Zope	Zope	NNP
zshrc	zshrc	NNP
Zumero	Zumero	NNP
Zune	Zune	NNP
ZURB	ZURB	NNP
Zuul	Zuul	NNP
ZXing	ZXing	NNP
Zynq	Zynq	NNP
Zypper	Zypper	NNP
